有一点儿	有一点儿 abit
有能力的	有能力的 able
土著居民	土著居民 aborigines
意外的事	意外的事 accident
行动法令	行动法令 act
把加到上	把加到上 addto
少数几个	少数几个 afew
负担得起	负担得起 afford
经受得起	经受得起 afford
抽出时间	抽出时间 afford spare
不久以后	不久以后 afterawhile beforelong soonafter
一玻璃杯	一玻璃杯 aglassof
非常多的	非常多的 greatdeal
相当多的	相当多的 agoodmany plentyof
非常多地	非常多地 agreatdeal
达成共识	达成共识 agreeon
航空公司	航空公司 airline
航空系统	航空系统 airline
遍及全国	遍及全国 alloverthecountry
一切顺利	一切顺利 allthebest
一年到头	一年到头 alltheyearround
自始至终	自始至终 allthrough through
阿尔托夫	阿尔托夫 Altorf
诸如此类	诸如此类 andsoon
英语晚会	英语晚会 anEnglishevening
受到惩罚	受到惩罚 answerfor
不管怎样	不管怎样 anyhow anyway
什么事物	什么事物 anything
任何事物	任何事物 anything
任何地方	任何地方 anywhere
阿拉伯人	阿拉伯人 Arab
阿拉伯的	阿拉伯的 Arabian
接力赛跑	接力赛跑 arelay relay
起来	起来 arise
到达某地	到达某地 arriveat inaplace
亚洲人的	亚洲人的 Asian
不仅而且	不仅而且 aswellas
正吃早饭	正吃早饭 atbreakfast
一个电话	一个电话 atelephonecall
在大海上	在大海上 atsea
在的尽头	在的尽头 attheendof
在的脚下	在的脚下 atthefootof
澳大利亚	澳大利亚 Australia
奥地利的	奥地利的 Austrian
不正确的	不正确的 bad
有整齐地	有整齐地 badly
没有礼貌	没有礼貌 badmanners
脾气坏的	脾气坏的 badtempered
好容易才	好容易才 barely
讨价还价	讨价还价 bargain
豆科植物	豆科植物 bean
四足动物	四足动物 beast
忙于某事	忙于某事 bebusywithsth
与有关系	与有关系 beconnectedwith
就寝时间	就寝时间 bedtime
因而著名	因而著名 befamousfor
先做某事	先做某事 begiwith
感到惊奇	感到惊奇 besurprised
对不确定	对不确定 beuncertainabout
大一些的	大一些的 bigger
北美野牛	北美野牛 bison
划船比赛	划船比赛 boatrace
用开水煮	用开水煮 boil
两个人都	两个人都 both
少年时代	少年时代 boyhood
休息时间	休息时间 break
破门而入	破门而入 breakinto
违反法律	违反法律 breakthelaw
违反规定	违反规定 breaktherule
亮闪闪地	亮闪闪地 brilliantly
英国人的	英国人的 British English
广播节目	广播节目 broadcast
逐步建立	逐步建立 buildup
突然发生	突然发生 burst burstforth
突然发作	突然发作 burst
突然爆发	突然爆发 burstforth
大声叫喊	大声叫喊 burstout
烧成平地	烧成平地 burtotheground
公共汽车	公共汽车 bus
布什大厦	布什大厦 BushHouse
美洲毒蛇	美洲毒蛇 bushmaster
每周商刊	每周商刊 BusinessWeekly
屠宰屠夫	屠宰屠夫 butcher
在结束时	在结束时 bytheendof
到那时候	到那时候 bythen
中国民航	中国民航 CAAC
大声叫唤	大声叫唤 callout
金属容器	金属容器 can
加拿大人	加拿大人 Canadian
陆军上尉	陆军上尉 captain
海军上校	海军上校 captain
漫不经心	漫不经心 careless
加勒比海	加勒比海 Caribbean
欢乐之歌	欢乐之歌 carol
四轮马车	四轮马车 carriage carriage
继续下去	继续下去 carryon on
经济作物	经济作物 cashcrop
呱呱地叫	呱呱地叫 caw
百分度的	百分度的 centigrade
当然可以	当然可以 certainly
冠军称号	冠军称号 championship
改变主意	改变主意 changeone'smind
性格培养	性格培养 charactertraining
要求收费	要求收费 charge
索价费用	索价费用 charge
巧克力糖	巧克力糖 chocolate
基督教徒	基督教徒 Christian
民权法案	民权法案 CivilRightsAct
同班同学	同班同学 classmate
把清除掉	把清除掉 clearaway
天气放晴	天气放晴 clearup
咬紧牙关	咬紧牙关 clench
不灵活的	不灵活的 clumsy
可口可乐	可口可乐 CocaCola
苏醒过来	苏醒过来 comebacktolife
来吧现实	来吧现实 cometrue
共产主义	共产主义 communism
正式会议	正式会议 conference
有联系的	有联系的 connected
咕咕地叫	咕咕地叫 coo
抄写副本	抄写副本 copy
对的改正	对的改正 correct
长沙发椅	长沙发椅 couch
全体船员	全体船员 crew
机组人员	机组人员 crew
关键性的	关键性的 critical
十字路口	十字路口 crossing
人行横道	人行横道 crossing
大声呼喊	大声呼喊 cryout
立方体的	立方体的 cubic
立方形的	立方形的 cubic
文化上的	文化上的 cultural
齐根割掉	齐根割掉 cutup
日日夜夜	日日夜夜 dayandnight
一天天地	一天天地 daybyday
防御工事	防御工事 defenceworks
百货商场	百货商场 departmentstore
有决心的	有决心的 determined
直接引语	直接引语 directspeech
不利条件	不利条件 disadvantage
不同意见	不同意见 disagree
意见不同	意见不同 disagreement
做件好事	做件好事 doagooddeed
预习功课	预习功课 doone'slessons
复习功课	复习功课 doone'slessons
付诸行动	付诸行动 dothedeed
双光眼镜	双光眼镜 doublespectacles
得出结论	得出结论 drawaconclusion
童装穿衣	童装穿衣 dress
钻头落下	钻头落下 drill
顺便走访	顺便走访 dropin
欧洲金币	欧洲金币 ducat
东部非洲	东部非洲 EastAfrica
经济学的	经济学的 economic
爱因斯坦	爱因斯坦 Einstein
不是就是	不是就是 eitheror
无止境的	无止境的 endless
火车司机	火车司机 engineer
英国男人	英国男人 Englishman
享受乐趣	享受乐趣 enjoy
过得愉快	过得愉快 enjoyoneself
耳鼻喉科	耳鼻喉科 ENT
欧洲联盟	欧洲联盟 EuropeanUnion
节日前夕	节日前夕 eve
无论何时	无论何时 ever whenever
从那时起	从那时起 eversince fromthenon
每样东西	每样东西 everything
无论哪里	无论哪里 everywhere
恰恰正是	恰恰正是 exactly
使兴奋的	使兴奋的 excite
对不起。	对不起。 Excuseme
有经验的	有经验的 experienced
幻想中的	幻想中的 fairy
神话故事	神话故事 fairytales
最喜爱的	最喜爱的 favorite
觉得想做	觉得想做 feellikedoing
战地医院	战地医院 fieldhospital
野战医院	野战医院 fieldhospital
消防人员	消防人员 firefighter
固定装置	固定装置 fixture
火焰般的	火焰般的 flaming
足球运动	足球运动 football
高速公路	高速公路 freeway
法国人的	法国人的 French
无经验的	无经验的 fresh
不熟练的	不熟练的 fresh
一代一代	一代一代 fromgenerationtogeneration
世世代代	世世代代 fromgenerationtogeneration
从此以后	从此以后 fromnowon
长柄平锅	长柄平锅 fryingpan
有趣的事	有趣的事 fun
滑稽可笑	滑稽可笑 funny
更进一步	更进一步 further
一般说来	一般说来 generallyspeaking
天才人物	天才人物 genius
和睦相处	和睦相处 getalong
为准备好	为准备好 getreadyfor
有天赋的	有天赋的 gifted
有才华的	有才华的 gifted learned
为而献身	为而献身 giveone'slifefor
精疲力竭	精疲力竭 giveout
匆匆一看	匆匆一看 glance
vi闪耀	vi闪耀 glare
向人瞪眼	向人瞪眼 glareat
怒目注视	怒目注视 glareat
继续进行	继续进行 goaheadwith
足球球门	足球球门 goal goal
食物变坏	食物变坏 gobad
坐飞机去	坐飞机去 gobyair
出去散步	出去散步 goforawalk gooutforawalk
很有礼貌	很有礼貌 goodmanners
举行罢工	举行罢工 goonstrike
上电影院	上电影院 gotothecinema
去看电影	去看电影 gotothecinema
姑且承认	姑且承认 grant
地球引力	地球引力 gravity
蔬菜商人	蔬菜商人 greengrocer
水果商人	水果商人 greengrocer
楼房底层	楼房底层 groundfloor
渐渐变得	渐渐变得 grow
长大成人	长大成人 growup
防护装置	防护装置 guard
把手使用	把手使用 handle
把拿出来	把拿出来 handout takeout
把挂起来	把挂起来 hangup
偶然发生	偶然发生 happen
对有天赋	对有天赋 haveagiftfor
旅行愉快	旅行愉快 haveagoodtrip
进行测验	进行测验 haveatest
一丝不挂	一丝不挂 havenothingon
直升飞机	直升飞机 helicopter
有帮助的	有帮助的 helpful
把藏起来	把藏起来 hid hidden hide
多小山的	多小山的 hilly
业余爱好	业余爱好 hobby
举行会议	举行会议 holdameeting
趾高气扬	趾高气扬 holdone'sheadhigh
家庭作业	家庭作业 homework
给以荣誉	给以荣誉 honour
有希望地	有希望地 hopefully
极讨厌的	极讨厌的 horrible
用马拉的	用马拉的 horsedrawn
家庭主妇	家庭主妇 housewife
家务劳动	家务劳动 housework
无论如何	无论如何 however
匈牙利的	匈牙利的 Hungarian
十二级风	十二级风 hurricane
习惯用语	习惯用语 idiom phrase
不规范的	不规范的 illformed
不可能的	不可能的 impossible
一刹那间	一刹那间 inaflash
总而言之	总而言之 inaword
在战斗中	在战斗中 inbattle
上着镣铐	上着镣铐 inchains
在囚禁中	在囚禁中 inchains
有主见的	有主见的 independent
印度人的	印度人的 Indian
非直接的	非直接的 indirect
进入室内	进入室内 indoors
为了纪念	为了纪念 inhonourof
成一直线	成一直线 inline
也就是说	也就是说 inotherwords
换句话说	换句话说 inotherwords
作为报答	作为报答 inreturn
坚持认为	坚持认为 insiston
坚决要求	坚决要求 insiston
公共机构	公共机构 institution
发生兴趣	发生兴趣 interest
感兴趣的	感兴趣的 interested
有意思的	有意思的 interesting
境遇相同	境遇相同 inthesameboat
同舟共济	同舟共济 inthesameboat
看不见的	看不见的 invisible
爱尔兰的	爱尔兰的 Irish
不规则的	不规则的 irregular
我明白了	我明白了 Isee
意大利的	意大利的 Italian
没有关系	没有关系 Itdoesn'tmatter
日本人的	日本人的 Japanese
爵士音乐	爵士音乐 jazz
爵士舞曲	爵士舞曲 jazz
连接起来	连接起来 joinup
联合起来	联合起来 joinup
开玩笑地	开玩笑地 jokingly
等一会儿	等一会儿 justamoment
不久以前	不久以前 justnow
正在那时	正在那时 justthen
记录下来	记录下来 keeparecord
阻止向前	阻止向前 keepback
保持健康	保持健康 keepfit
保持平衡	保持平衡 keepone'sbalance
履行诺言	履行诺言 keepone'spromise
不让进来	不让进来 keepout
使不进入	使不进入 keepoutof
保持沉默	保持沉默 keepsilent
关键人物	关键人物 keyfigure
把踢出去	把踢出去 kickout
蚕花娘子	蚕花娘子 LadySilkworm
大片陆地	大片陆地 landmass
刚过去的	刚过去的 last
拉丁语族	拉丁语族 Latinfamily
摆设餐具	摆设餐具 laythetable
最主要的	最主要的 leading
过的生活	过的生活 leadlife
腿固定器	腿固定器 legbrace
很可能的	很可能的 likely
没有多少	没有多少 little
有生气的	有生气的 lively
以为主食	以为主食 liveon
生活条件	生活条件 livingconditions
一条面包	一条面包 loaf
很久以前	很久以前 longago longbefore
仔细查看	仔细查看 lookaround lookround lookthrough
封建领主	封建领主 lord
运货汽车	运货汽车 lorry
载货卡车	载货卡车 lorry
失去信心	失去信心 loseheart
丧失视力	丧失视力 loseone'ssight
有魔力的	有魔力的 magic
作出决定	作出决定 makeadecision
冲过去拿	冲过去拿 makeadivefor
为作计划	为作计划 makeaplanfor
录制唱片	录制唱片 makearecord
量入为出	量入为出 makeendsmeet
与交朋友	与交朋友 makefriendswith
制成做成	制成做成 makeinto
使转变为	使转变为 makeinto
证明论点	证明论点 makeone'spoint
取得进步	取得进步 makeprogress
很有意义	很有意义 makesense
发出声音	发出声音 makesounds sound
整理床铺	整理床铺 makethebed
设法对付	设法对付 manage
最大限度	最大限度 maximum
最大量的	最大量的 maximum
五月二日	五月二日 May2nd
医疗护理	医疗护理 medicalcare
体格检查	体格检查 medicalexamination
金属制造	金属制造 metal
百万富翁	百万富翁 millionaire
成百万的	成百万的 millionsof
开采矿物	开采矿物 mine
少数民族	少数民族 minority
可移动的	可移动的 mobile
或多或少	或多或少 moreorless
多少有点	多少有点 moreorless
口对口的	口对口的 mouthtomouth
继续移动	继续移动 moveon
科克先生	科克先生 MrCook
比好得多	比好得多 muchbetterthan
了不起的	了不起的 muchof
全国性的	全国性的 national nationwide
博物学家	博物学家 naturalist
神经质的	神经质的 nervous
网状系统	网状系统 network
从来没有	从来没有 never
不必顾虑	不必顾虑 nevermind
新闻记者	新闻记者 newspaperreporter
新闻影片	新闻影片 newsreel
紧挨着的	紧挨着的 next
尼日利亚	尼日利亚 Nigeria
运气不佳	运气不佳 noluck
非暴力的	非暴力的 nonviolent
非白种人	非白种人 nonwhite
诺曼第人	诺曼第人 Norman
一点也不	一点也不 notatall
没有东西	没有东西 nothing
不但而且	不但而且 notonlybutalso
直到之前	直到之前 notuntil
原子核的	原子核的 nuclear
原子能的	原子能的 nuclear
核动力的	核动力的 nuclear
核废弃物	核废弃物 nuclearwaste
高级职员	高级职员 official
官方语言	官方语言 officiallanguage
雾都孤儿	雾都孤儿 OliverTwist
奥林匹克	奥林匹克 Olympic
进行下去	进行下去 on
很早以前	很早以前 onceuponatime
一只眼的	一只眼的 oneeyed
才唯一的	才唯一的 only
另一方面	另一方面 ontheotherhand
不早不晚	不早不晚 ontime
施行手术	施行手术 operate
给动手术	给动手术 operateon
外科手术	外科手术 operation
口头上的	口头上的 oral
运行轨道	运行轨道 orbit
有秩序的	有秩序的 orderly
组织起来	组织起来 organize
别的东西	别的东西 other
我们自己	我们自己 ourselves
我们亲自	我们亲自 ourselves
外部空间	外部空间 outerspace
被放逐者	被放逐者 outlaw
电源插座	电源插座 outlet
没有工作	没有工作 outofwork
在另一处	在另一处 over
所有关系	所有关系 ownership
太平洋的	太平洋的 Pacific
一大堆的	一大堆的 packsof
桨形工具	桨形工具 paddle
使痛苦的	使痛苦的 painful
巴基斯坦	巴基斯坦 Pakistan
小块土地	小块土地 patch
付出代价	付出代价 payforsth
黑色便士	黑色便士 PennyBlack
物理学家	物理学家 physicist
一堆堆的	一堆堆的 pilesandpilesof
可惜的事	可惜的事 pity
塑料制品	塑料制品 plastic plastics
游戏伙伴	游戏伙伴 playmate
扮演角色	扮演角色 playtheroleof
使人高兴	使人高兴 please
使人满意	使人满意 please
有礼貌的	有礼貌的 polite
有教养的	有教养的 polite
流行音乐	流行音乐 popmusic
流行歌手	流行歌手 popstar
受欢迎的	受欢迎的 popstar
葡萄牙语	葡萄牙语 Portuguese
邮政局长	邮政局长 postmaster
倾盆而下	倾盆而下 pour pourdown
强有力的	强有力的 powerful strong
无力量的	无力量的 powerless
草原犬鼠	草原犬鼠 prairiedog
普林斯顿	普林斯顿 Princeton
很有能的	很有能的 probable
普鲁士人	普鲁士人 Prussian
渡过难关	渡过难关 pullthrough
脱离险境	脱离险境 pullthrough
把向上推	把向上推 pushup
把收起来	把收起来 putaway
把放进来	把放进来 putin
增加体重	增加体重 putonweight
四分之一	四分之一 quarter
颇有几个	颇有几个 quiteafew
小型考试	小型考试 quiz
种族歧视	种族歧视 racialdiscrimination
放射性的	放射性的 radioactive
放射现象	放射现象 radioactivity
倒不如说	倒不如说 ratherthan
伸手去够	伸手去够 reach
准备好的	准备好的 ready
有道理的	有道理的 reasonable
转移呼叫	转移呼叫 redirect redirection
使改方向	使改方向 redirect
更改方向	更改方向 redirection
水中映像	水中映像 reflection
相互依存	相互依存 relativity
宗教信仰	宗教信仰 religion
其余的人	其余的人 remainder
vi再婚	vi再婚 remarry
请向致意	请向致意 Remembermeto
修理工作	修理工作 repairs
研究人员	研究人员 researcher
剩余部分	剩余部分 rest
其余休息	其余休息 rest
重新统一	重新统一 reunite
重新使用	重新使用 reuse
循环使用	循环使用 reuse
骑自行车	骑自行车 ride
乘车旅行	乘车旅行 ride
右边权利	右边权利 right
挂断电话	挂断电话 ringoff
起来反抗	起来反抗 riseup
环绕一周	环绕一周 round
有桨的船	有桨的船 rowboat
合成橡胶	合成橡胶 rubber
赛跑的人	赛跑的人 runner
女售货员	女售货员 salesgirl
同样的事	同样的事 same
一模一样	一模一样 same
夹馅面包	夹馅面包 sandwich
旧金山湾	旧金山湾 SanFranciscoBay
自然科学	自然科学 science
苏格兰的	苏格兰的 Scots
苏格兰人	苏格兰人 Scottish
发尖叫声	发尖叫声 screech
航海技术	航海技术 seamanship
第二手的	第二手的 secondhand
派人去叫	派人去叫 sendfor
派人去请	派人去请 sendfor
把往上送	把往上送 sendup
灵敏元件	灵敏元件 sensor
使和分离	使和分离 separatefrom
动脑筋的	动脑筋的 serious
创新纪录	创新纪录 setanewrecord
树立榜样	树立榜样 setanexample
释放某人	释放某人 setfree
莎士比亚	莎士比亚 Shakespeare
遗憾的事	遗憾的事 shame
共同使用	共同使用 share
分享某事	分享某事 shareinsomething
把装上船	把装上船 ship
男式衬衫	男式衬衫 shirt
商店橱窗	商店橱窗 shopwindow
之后立即	之后立即 shortlyafter
高声呼喊	高声呼喊 shout
舒兹伯利	舒兹伯利 Shrewsbury
肩并肩地	肩并肩地 sidebyside
无对话的	无对话的 silent
高度赞扬	高度赞扬 singhighpraisefor
有技能的	有技能的 skilled
摩天大楼	摩天大楼 skyscraper
奴隶制度	奴隶制度 slavery
反应慢的	反应慢的 slow
散发气味	散发气味 smell smelt
有臭味的	有臭味的 smelly
消除障碍	消除障碍 smoothaway
克服困难	克服困难 smoothaway
轻蔑地笑	轻蔑地笑 sneer
这样看来	这样看来 so
社会主义	社会主义 socialism
索芙朗妮	索芙朗妮 Sofronie
不知怎地	不知怎地 somehow
宇宙飞船	宇宙飞船 spaceship
西班牙语	西班牙语 Spanish
空余时间	空余时间 sparetime
业余时间	业余时间 sparetime
清楚地说	清楚地说 speakout
迅速前进	迅速前进 speed
加快速度	加快速度 speedup
拼写课本	拼写课本 spellingbook
花费金钱	花费金钱 spend
花费时间	花费时间 spend
正方形的	正方形的 square
四方块的	四方块的 square
平方公里	平方公里 squarekilometres
站在旁边	站在旁边 standby
立足之地	立足之地 standingroom
手杖粘粘	手杖粘粘 stick
静止不动	静止不动 still
狂暴天气	狂暴天气 storm
漫步	漫步 stroll
同作斗争	同作斗争 struggleagainst
仔细观察	仔细观察 study
仔细考虑	仔细考虑 study thinkover useone'shead
有成就的	有成就的 successful
这样的人	这样的人 such
手提皮箱	手提皮箱 suitcase
超级市场	超级市场 supermarket
有把握的	有把握的 sure
摇动	摇动 sway
四处游动	四处游动 swimabout
接通电流	接通电流 switchon
关收音机	关收音机 switchtheradiooff
随身带着	随身带着 takealong
采取行动	采取行动 takeanaction
对感兴趣	对感兴趣 takeaninterestin
照一张相	照一张相 takeaphotograph
认为当然	认为当然 takeforgranted
跟人学习	跟人学习 takelessons
站在一边	站在一边 takesides
支持某人	支持某人 takethesideof
拿起武器	拿起武器 takeuparms
储水容器	储水容器 tank
煤气龙头	煤气龙头 tap
磁带录音	磁带录音 taperecording
出租汽车	出租汽车 taxi
同队队员	同队队员 teammate
连根拔起	连根拔起 tearup
泰晤士河	泰晤士河 Thames
巴士底狱	巴士底狱 theBastille
路之终点	路之终点 theendoftheroad
第二层楼	第二层楼 thefirstfloor
林肯一家	林肯一家 theLincoln
神秘城堡	神秘城堡 theMagicCastle
它们自己	它们自己 themselves
诺贝尔奖	诺贝尔奖 theNobelPrize
独立战争	独立战争 theWarofIndependence
工人阶级	工人阶级 theworkingclass
国际广播	国际广播 theWorldService
匆匆脱掉	匆匆脱掉 throwoff
一段时间	一段时间 time while while
太而不能	太而不能 tooto
直到今天	直到今天 tothisday
生意交易	生意交易 trade
培训中心	培训中心 trainingcentre
运输工具	运输工具 transport
长途旅行	长途旅行 travel
金银财宝	金银财宝 treasure
成群结队	成群结队 troop
竭尽所能	竭尽所能 tryone'sbest
选拔表演	选拔表演 tryout
参加选拔	参加选拔 tryout
把打发走	把打发走 turnaway
把翻过来	把翻过来 turover
闪闪发光	闪闪发光 twinkle
联合王国	联合王国 UK
在下划线	在下划线 underline
不公平的	不公平的 unfair unjust
不公正的	不公正的 unfair
不合适的	不合适的 unfit
不健康的	不健康的 unhealthy
不卫生的	不卫生的 unhealthy
不重要的	不重要的 unimportant
不亲切的	不亲切的 unkind
不知道的	不知道的 unknown
卸下货物	卸下货物 unload
未看见的	未看见的 unseen
未销售的	未销售的 unsold
不成功的	不成功的 unsuccessful
直到为止	直到为止 until
未动过的	未动过的 untouched
不常见的	不常见的 unusual
不平常的	不平常的 unusual
上上下下	上上下下 upanddown upanddown
前前后后	前前后后 upanddown
来来回回	来来回回 upanddown
乱七八糟	乱七八糟 upsidedown
在楼上的	在楼上的 upstairs
过去常常	过去常常 usedto
有价值的	有价值的 valuable worth worthy
维多利亚	维多利亚 Victoria
电视电话	电视电话 videophone
可视电话	可视电话 videophone
暴力行为	暴力行为 violence
排队等候	排队等候 waitinline
女服务员	女服务员 waitress
预先通知	预先通知 warn
滑水运动	滑水运动 waterskiing
vi流泪	vi流泪 weep
真是遗憾	真是遗憾 Whatapity
无论什么	无论什么 whatever
什么时候	什么时候 when
当的时候	当的时候 when while
或者或者	或者或者 whetheror
无论哪个	无论哪个 whichever
无论哪些	无论哪些 whichever
在的时候	在的时候 while
分布广的	分布广的 widespread
野生动物	野生动物 wildlife
心甘情愿	心甘情愿 willing
蜿蜒前进	蜿蜒前进 windone'sway
观看橱窗	观看橱窗 windowshop
无线电的	无线电的 wireless
无线电话	无线电话 wirelesstelephone
有智慧的	有智慧的 wise
有见识的	有见识的 wise
羊毛制的	羊毛制的 woollen
继续工作	继续工作 workaway
努力学习	努力学习 workhardat
最恶劣的	最恶劣的 worst
有毛病的	有毛病的 wrong
少先队员	少先队员 YoungPioneer
苏黎世	苏黎世 Zurich
有点儿	有点儿 abit
能干的	能干的 able
一大块	一大块 ablockof
在上面	在上面 above ontopof up upon
上面的	上面的 above
到国外	到国外 abroad
在国外	在国外 abroad
缺席的	缺席的 absent
抽象的	抽象的 abstract
深奥的	深奥的 abstract
使认识	使认识 acquaint
使了解	使了解 acquaint
另一边	另一边 across
积极的	积极的 active
主动的	主动的 active
能动性	能动性 activity
男演员	男演员 actor
女演员	女演员 actress
实际的	实际的 actual practical
现实的	现实的 actual
实际上	实际上 actually infact
加法机	加法机 addingmachine
通讯处	通讯处 address
形容词	形容词 adjective
先进的	先进的 advanced
高级的	高级的 advanced senior
做广告	做广告 advertise
登广告	登广告 advertisement
非洲的	非洲的 African
在后面	在后面 after behind behind
别忘了	别忘了 afterall
放学后	放学后 afterschool
下课后	下课后 afterschool
再一次	再一次 again onceagain oncemore
再三地	再三地 againandagain
反复地	反复地 againandagain
加油站	加油站 agasstation
大量的	大量的 greatdeal agreatdeal great much packsof
很多的	很多的 agoodmany great
农业的	农业的 agricultural
农学的	农学的 agricultural
在前面	在前面 ahead aheadof before infrontof
在前头	在前头 ahead
航空站	航空站 airport
飞机场	飞机场 airport
所有的	所有的 all
全部的	全部的 all entire
一辈子	一辈子 allone'slife
差不多	差不多 almost nearly
单独的	单独的 alone separate
和一起	和一起 along
出声地	出声地 aloud
大声地	大声地 aloud
字母表	字母表 alphabet
美国的	美国的 American
美洲的	美洲的 American
美国人	美国人 American
美洲人	美洲人 American
在中间	在中间 among between inthemiddleof
在之间	在之间 among
艾默利	艾默利 Amory
发怒地	发怒地 angrily
愤怒地	愤怒地 angrily
发怒的	发怒的 angry
生气的	生气的 angry angry
愤怒的	愤怒的 angry
脚脖子	脚脖子 ankle
开幕式	开幕式 anopeningceremony
不同的	不同的 another different various
另一个	另一个 another theother
对负责	对负责 answerfor
留言机	留言机 answeringmachine
南极洲	南极洲 Antarctica
抗生素	抗生素 antibiotics
渴望的	渴望的 anxious eager
忧虑的	忧虑的 anxious
焦急的	焦急的 anxious
任何的	任何的 any
任何人	任何人 anybody anyone
什么事	什么事 anything
任何事	任何事 anything
愚人节	愚人节 AprilFools'Day
建筑师	建筑师 architect
建筑学	建筑学 architecture
扶手椅	扶手椅 armchair
在周围	在周围 around around
艺术品	艺术品 art
美术家	美术家 artist
艺术家	艺术家 artist
象一样	象一样 as
事实上	事实上 asamatteroffact inactualfact
烟灰缸	烟灰缸 ashtray
亚洲的	亚洲的 Asian
在一边	在一边 aside
睡着的	睡着的 asleep
使惊讶	使惊讶 astonish
惊人的	惊人的 astonishing
同样地	同样地 aswell
早餐时	早餐时 atbreakfast
在家里	在家里 athome athome
未被捕	未被捕 atlarge
在夜里	在夜里 atnight
在晚上	在晚上 atnight
在中午	在中午 atnoon
原子的	原子的 atomic
在学校	在学校 atschool
在航海	在航海 atsea
注意地	注意地 attentively
在岁月	在岁月 attheageof
在岁时	在岁时 attheageof
在底端	在底端 atthebottom
在边上	在边上 attheedgeof
在末梢	在末梢 attheendof
不超过	不超过 atthemost
在工作	在工作 atwork
奥地利	奥地利 Austria
平均的	平均的 average
醒着的	醒着的 awake
后面的	后面的 back hind
向后的	向后的 backward
腐败的	腐败的 bad
严重的	严重的 bad serious severe
粗糙地	粗糙地 badly
严重地	严重地 badly
恶劣地	恶劣地 badly
银行家	银行家 banker
赤脚的	赤脚的 barefooted
廉价货	廉价货 bargain
根据地	根据地 base
基本的	基本的 basic prime
平衡木	平衡木 beam
为担心	为担心 beanxiousabout
美丽的	美丽的 beautiful lovely pretty
优美的	优美的 beautiful
出生于	出生于 beborn comefrom
忙着做	忙着做 bebusydoing
贝多芬	贝多芬 Beethoven
对熟悉	对熟悉 befamiliarwith
在之前	在之前 before to
充满的	充满的 befullof full
从开始	从开始 begiwith
请原谅	请原谅 begone'spardon
对不起	对不起 begone'spardon sorry
感兴趣	感兴趣 beinterestedin
比利时	比利时 Belgium
减压舱	减压舱 bellows
在下面	在下面 below under
由制造	由制造 bemadefrom
在制造	在制造 bemadein
用制造	用制造 bemadeof
由组成	由组成 bemadeupof
由构成	由构成 bemadeupof
工作台	工作台 bench
使弯曲	使弯曲 bend
在罢工	在罢工 beonstrike
以为荣	以为荣 beproudof
以自豪	以自豪 beproudof takepridein
与有关	与有关 berelatedto havedowith
在旁边	在旁边 beside
除以外	除以外 besides
最好的	最好的 best
最好地	最好地 best
畅销书	畅销书 bestseller
被撕开	被撕开 betornopen
较好的	较好的 better
更好的	更好的 better
不合适	不合适 beunfitfor
不胜任	不胜任 beunfitfor
习惯于	习惯于 beusedto getusedto
有毛病	有毛病 bewrongwith
在那边	在那边 beyond over overthere
在远处	在远处 beyond
脚踏车	脚踏车 bicycle bike
自行车	自行车 bicycle bike cycle
重要的	重要的 big great important main
生物学	生物学 biology
出生地	出生地 birthplace
一点地	一点地 bitbybit
怀恨的	怀恨的 bitter
厉害的	厉害的 bitter
苦苦地	苦苦地 bitterly
悲痛地	悲痛地 bitterly
黑色的	黑色的 black
布莱克	布莱克 Black
羊毛毯	羊毛毯 blanket
短上衣	短上衣 blouse
女衬衫	女衬衫 blouse
蓝色的	蓝色的 blue
小轮船	小轮船 boat
罗宾汉	罗宾汉 BobinHood
身势语	身势语 bodylanguage
水开了	水开了 boil
使沸腾	使沸腾 boil
长统靴	长统靴 boot
厌烦的	厌烦的 bored
波士顿	波士顿 Boston
植物学	植物学 botany
男朋友	男朋友 boyfriend
固定器	固定器 brace
点字法	点字法 braille
布兰敦	布兰敦 Brandon
勇敢的	勇敢的 brave
出毛病	出毛病 breakdown
不运转	不运转 breakdown
简洁的	简洁的 brief
明亮的	明亮的 bright light
耀眼的	耀眼的 bright glaring
聪明的	聪明的 bright clever wise
伶俐的	伶俐的 bright clever smart
光辉的	光辉的 brilliant
辉煌的	辉煌的 brilliant splendid
灿烂地	灿烂地 brilliantly
使倒下	使倒下 bringdown
使前进	使前进 bringon
不列颠	不列颠 Britain
英国的	英国的 British English
广阔的	广阔的 broad vast
咖啡色	咖啡色 brown
建筑物	建筑物 building
布告牌	布告牌 bulletinboard
把烧光	把烧光 burtotheground
灌木丛	灌木丛 bush
矮树丛	矮树丛 bush
停车站	停车站 busstop stop
不迟于	不迟于 by by
到为止	到为止 by
在附近	在附近 by
乘飞机	乘飞机 byair
白天里	白天里 byday
回头见	回头见 byebye
到时候	到时候 bythetime
顺便说	顺便说 bytheway
乘火车	乘火车 bytrain
卷心菜	卷心菜 cabbage
洋白菜	洋白菜 cabbage
咖啡馆	咖啡馆 cafe
回电话	回电话 callback ringback
平静地	平静地 calmly inpeace quietly
沉着地	沉着地 calmly
照相机	照相机 camera
摄相机	摄相机 camera
宿营营	宿营营 camp
加拿大	加拿大 Canada
独木舟	独木舟 canoe
小汽车	小汽车 car
谨慎的	谨慎的 careful
小心的	小心的 careful
仔细的	仔细的 careful
小心地	小心地 carefully
仔细地	仔细地 carefully
粗心地	粗心地 carelessly
客车厢	客车厢 carriage
胡萝卜	胡萝卜 carrot
小推车	小推车 cart
动画片	动画片 cartoon
收款台	收款台 cashdesk
蓖麻油	蓖麻油 castoroil
使产生	使产生 cause
使发生	使发生 cause
天花板	天花板 ceiling
庆祝会	庆祝会 celebration
中心的	中心的 central
中央的	中央的 central
一定的	一定的 certain
确定的	确定的 certain
无疑的	无疑的 certain
无疑地	无疑地 certainly
优胜者	优胜者 champion
锦标赛	锦标赛 championship
可能性	可能性 chance possibility
把变成	把变成 changeinto turinto
航海图	航海图 chart
廉价地	廉价地 cheaply
骗欺诈	骗欺诈 cheat
化学物	化学物 chemical
化学家	化学家 chemist
药剂师	药剂师 chemist
主要的	主要的 chief main major
首要的	首要的 chief prime
中国的	中国的 Chinese
中国人	中国人 Chinese
太极拳	太极拳 Chineseboxing
巧克力	巧克力 chocolate
圣诞节	圣诞节 Christmas
雪茄烟	雪茄烟 cigar
电影院	电影院 cinema
盘旋圆	盘旋圆 circle
公民权	公民权 citizenship
国内的	国内的 civil
干净的	干净的 clean
清洁的	清洁的 clean
弄干净	弄干净 clean
擦干净	擦干净 clean
清楚的	清楚的 clear sharp
清晰的	清晰的 clear
明白地	明白地 clearly
清晰地	清晰地 clearly
书记员	书记员 clerk
办事员	办事员 clerk
机灵的	机灵的 clever
咔嗒声	咔嗒声 click
小房间	小房间 closet
多云的	多云的 cloudy
阴天的	阴天的 cloudy
俱乐部	俱乐部 club
笨拙的	笨拙的 clumsy
海岸线	海岸线 coastline
可可树	可可树 cocoa
可可粉	可可粉 cocoa
冷血的	冷血的 coldblooded
冷淡地	冷淡地 coldly
无情地	无情地 coldly
收藏品	收藏品 collection
收集物	收集物 collection
柱状物	柱状物 column
使联合	使联合 combine
使结合	使结合 combine
向扑来	向扑来 comeat
想起来	想起来 comeback
从离开	从离开 comeoff
跟我来	跟我来 comeon
走过来	走过来 comeup
舒服的	舒服的 comfortable
轻松的	轻松的 comfortable
普通的	普通的 common ordinary widespread
一般的	一般的 common
共同的	共同的 common
与相比	与相比 comparedto
竞赛者	竞赛者 competitor
比赛者	比赛者 competitor player
完全地	完全地 completely entirely fully well
彻底地	彻底地 completely entirely
作曲家	作曲家 composer musician
压缩的	压缩的 compressed
计算机	计算机 computer
音乐会	音乐会 concert
演奏会	演奏会 concert
推断出	推断出 conclude
售票员	售票员 conductor
列车员	列车员 conductor
连结的	连结的 connected
与相连	与相连 connectwith
把看作	把看作 consider lookoas treat
经常地	经常地 constantly frequently regularly
不断地	不断地 constantly timeandtimeagain
满足的	满足的 content
满意的	满意的 content
连续的	连续的 continuous
持续的	持续的 continuous
对立面	对立面 contrary
便利的	便利的 convenient
方便的	方便的 convenient
炊事员	炊事员 cook
烹调书	烹调书 cookbook
小甜饼	小甜饼 cookie
习字帖	习字帖 copybook
习字本	习字本 copybook
珊瑚虫	珊瑚虫 coral
无线的	无线的 cordless wireless
正确的	正确的 correct proper right
正确地	正确地 correctly
恰当地	恰当地 correctly
v成本	v成本 cost
理事会	理事会 council
委员会	委员会 council
堂兄弟	堂兄弟 cousin
堂姊妹	堂姊妹 cousin
表兄弟	表兄弟 cousin
表姊妹	表姊妹 cousin
覆盖物	覆盖物 covering
合作者	合作者 coworker partner
破裂声	破裂声 crack
噼啪声	噼啪声 crack
哗啦声	哗啦声 crash
不安全	不安全 crazy
膏状物	膏状物 cream
松脆的	松脆的 crisp
鲜嫩的	鲜嫩的 crisp
紧要的	紧要的 critical
批判地	批判地 critically
十字架	十字架 cross
交叉点	交叉点 crossing
残忍的	残忍的 cruel
残酷的	残酷的 cruel
克鲁索	克鲁索 Cruse
立方米	立方米 cubicmetre
文化的	文化的 cultural
器皿柜	器皿柜 cupboard
奇妙的	奇妙的 curious
稀奇的	稀奇的 curious
好奇地	好奇地 curiously
每日的	每日的 daily
日常的	日常的 daily everyday
危险的	危险的 dangerous
致死的	致死的 deadly
致命的	致命的 deadly
昂贵的	昂贵的 dear expensive
高价的	高价的 dear
亲爱的	亲爱的 dear
深爱地	深爱地 dearly
热切地	热切地 dearly eagerly
十二月	十二月 December
下决心	下决心 decide makeupone'smind
深深地	深深地 deeply
深陷的	深陷的 deepset
明确的	明确的 definite
肯定的	肯定的 definite sure
美味的	美味的 delicious tasty
可口的	可口的 delicious tasty
高兴的	高兴的 delighted glad pleased
快乐的	快乐的 delighted enjoyable
设计者	设计者 designer
制图者	制图者 designer
写字台	写字台 desk
坚决的	坚决的 determined
献身于	献身于 devoteoneselfto
致力于	致力于 devoteoneselfto
把献于	把献于 devoteto
把用于	把用于 devoteto
金刚石	金刚石 diamond
日记簿	日记簿 diary
因而死	因而死 diefrom
差异的	差异的 different
不同地	不同地 differently
困难的	困难的 difficult hard
看一看	看一看 dipinto havealook takealook
径直地	径直地 directly
直接地	直接地 directly
指挥者	指挥者 director
地址录	地址录 directory
残废的	残废的 disabled
残疾的	残疾的 disabled
不同意	不同意 disagree disagreement
使失望	使失望 disappoint
失望的	失望的 disappointed
不赞成	不赞成 disapproval
不满意	不满意 disapproval
不舒适	不舒适 discomfort
使泄气	使泄气 discourage
泄气的	泄气的 discouraged
发现者	发现者 discoverer
一道菜	一道菜 dish
不喜爱	不喜爱 dislike
打发走	打发走 dismiss
不服从	不服从 disobey
稀疏的	稀疏的 distant
遥远的	遥远的 distant faraway
行政区	行政区 district region
把分成	把分成 divideinto
洋娃娃	洋娃娃 doll
做作业	做作业 doone'shomework
做功课	做功课 doone'slessons
出入口	出入口 doorway
买东西	买东西 dosomeshopping gofishing shop shopping
洗衣服	洗衣服 dosomewashing
往山脚	往山脚 downhill
在楼下	在楼下 downstairs
到楼下	到楼下 downstairs
做错事	做错事 dowrong
做坏事	做坏事 dowrong
素描图	素描图 drawing
工程图	工程图 drawing
可怕的	可怕的 dreadful frightful horrible terrible
连衣裙	连衣裙 dress
吹风机	吹风机 drier
吹积物	吹积物 drift
喝饮料	喝饮料 drink
驾驶员	驾驶员 driver
孙中山	孙中山 DrSunYatsen
预期的	预期的 due
约定的	约定的 due
阴暗的	阴暗的 dull grey
垃圾堆	垃圾堆 dump
垃圾箱	垃圾箱 dustbin
热切的	热切的 eager earnest
急切的	急切的 eager
渴望地	渴望地 eagerly
认真的	认真的 earnest serious
热心地	热心地 earnestly
认真地	认真地 earnestly
东方的	东方的 east eastern
东部的	东部的 eastern
不费力	不费力 easy
随和的	随和的 easygoing
吃个饱	吃个饱 eatone'sfill
起回声	起回声 echo
经济的	经济的 economic
埃及人	埃及人 Egyptian
埃及的	埃及的 Egyptian
用电的	用电的 electric
电气的	电气的 electrical
使触电	使触电 electrify
使充电	使充电 electrify
电子的	电子的 electronic
其他的	其他的 else
奋力号	奋力号 Endeavour
没完的	没完的 endless
恩格斯	恩格斯 Engels
发动机	发动机 engine motor
工程师	工程师 engineer
英格兰	英格兰 England
英语的	英语的 English
英国人	英国人 Englishman
愉快的	愉快的 enjoyable pleased
有趣的	有趣的 enjoyable interesting
足够的	足够的 enough
充分地	充分地 enough fully well wide wide
整个的	整个的 entire whole
平等的	平等的 equal
均等的	均等的 equal
平等地	平等地 equally
公平地	公平地 equally
小品文	小品文 essay
欧洲人	欧洲人 European
欧洲的	欧洲的 European
埃文斯	埃文斯 Evans
每个的	每个的 every
每天的	每天的 everyday
每件事	每件事 everything
每两年	每两年 everytwoyears
确切的	确切的 exact
准确的	准确的 exact
确切地	确切地 exactly exactly
精确地	精确地 exactly
极好的	极好的 excellent perfect wonderful
优秀的	优秀的 excellent
除之外	除之外 except exceptfor
使激动	使激动 excite
兴奋的	兴奋的 excited heated
激昂的	激昂的 excited
兴奋地	兴奋地 excitedly
激动地	激动地 excitedly
展览会	展览会 exhibition
存在物	存在物 existence
远征队	远征队 expedition
探险队	探险队 expedition
老练的	老练的 experienced
探险者	探险者 explorer
输出品	输出品 export
使暴露	使暴露 expose
特别地	特别地 extra
额外的	额外的 extra
外加的	外加的 extra
非常的	非常的 extraordinary
非凡的	非凡的 extraordinary remarkable
离奇的	离奇的 extraordinary
面对面	面对面 facetoface
不及格	不及格 fail
暗淡的	暗淡的 faint
微弱的	微弱的 faint
公平的	公平的 fair
晴朗的	晴朗的 fair fine
白晰的	白晰的 fair
金色的	金色的 fair golden
公正地	公正地 fairly
正当地	正当地 fairly
虚构的	虚构的 fairy
熟悉的	熟悉的 familiar
著名的	著名的 famous
有名的	有名的 famous
远离的	远离的 faraway
完全不	完全不 farfrom
农场主	农场主 farmer
牧场主	牧场主 farmer
迅速的	迅速的 fast quick rapid swift
不怕的	不怕的 fearless
无畏的	无畏的 fearless
联盟的	联盟的 federal
联邦的	联邦的 federal
把喂给	把喂给 feedto
女性的	女性的 female
妇女的	妇女的 female
发烧的	发烧的 feverish
少数的	少数的 few
很少数	很少数 few
纤维素	纤维素 fibre
猛烈的	猛烈的 fierce
拼命地	拼命地 fiercely
狂热地	狂热地 fiercely
第五十	第五十 fiftieth
把装满	把装满 fillwith
最后的	最后的 final last
美好的	美好的 fine nice
安全梯	安全梯 fireescape
牢固的	牢固的 firm tight
稳固的	稳固的 firm steady
紧紧地	紧紧地 firmly tight
坚定地	坚定地 firmly
牢牢地	牢牢地 firmly
修理好	修理好 fixup
火红的	火红的 flaming
转瞬间	转瞬间 flash
闪光灯	闪光灯 flash
手电筒	手电筒 flashlight
扁平的	扁平的 flat
平坦的	平坦的 flat smooth
平展的	平展的 flat
使满意	使满意 flatter
不飞的	不飞的 flightless
多雾的	多雾的 foggy
模糊的	模糊的 foggy
民间的	民间的 folk
追随者	追随者 follower
喜爱的	喜爱的 fond
爱好的	爱好的 fond
愚蠢地	愚蠢地 foolishly
荒谬地	荒谬地 foolishly
外国的	外国的 foreign
林务员	林务员 forester
以前的	以前的 former
从前的	从前的 former past
十四日	十四日 fortnight
两星期	两星期 fortnight
幸运的	幸运的 fortunate lucky
侥幸的	侥幸的 fortunate lucky
幸运地	幸运地 fortunately
创立者	创立者 founder
奠基者	奠基者 founder
第四日	第四日 fourth
易碎的	易碎的 fragile
法兰西	法兰西 France
弗朗兹	弗朗兹 Franz
自由的	自由的 free
空闲的	空闲的 free spare
免费的	免费的 free
自由地	自由地 freely
随意地	随意地 freely
法国的	法国的 French
法国人	法国人 Frenchman
经常的	经常的 frequent regular
频繁的	频繁的 frequent
屡次地	屡次地 frequently
频繁地	频繁地 frequently
新鲜的	新鲜的 fresh new
星期五	星期五 Friday
友好的	友好的 friendly kind
受惊的	受惊的 frightened
害怕的	害怕的 frightened
前面的	前面的 front
完全的	完全的 full total
专职的	专职的 fulltime
较远的	较远的 further
伽利略	伽利略 Galileo
汽车间	汽车间 garage
汽车库	汽车库 garage
园艺学	园艺学 gardening
天然气	天然气 gas naturalgas
大体的	大体的 general
笼统的	笼统的 general
一般地	一般地 generally
柔和的	柔和的 gentle soft
温柔的	温柔的 gentle
轻轻的	轻轻的 gentle
温柔地	温柔地 gently
柔和地	柔和地 gently
轻轻地	轻轻地 gently lightly softly
地理学	地理学 geography
地理书	地理书 geography
地质学	地质学 geology
德国的	德国的 German
德国人	德国人 German
盖斯勒	盖斯勒 Gessler
与联系	与联系 getintouchwith
与接触	与接触 getintouchwith
从下去	从下去 getoff
通电话	通电话 getthrough
巨大的	巨大的 giant huge large vast
女朋友	女朋友 girlfriend
提建议	提建议 giveadvice
做报告	做报告 giveatalk haveatalk
做讲演	做讲演 giveatalk
给上课	给上课 givelessonsto
乐意的	乐意的 glad
瞪眼的	瞪眼的 glaring
玻璃杯	玻璃杯 glass
球状物	球状物 globe
地球仪	地球仪 globe
不利于	不利于 goagainst
去钓鱼	去钓鱼 gofishing shopping
从事于	从事于 goinfor
黄色的	黄色的 golden yellow
金门桥	金门桥 GoldenGateBridge
早上好	早上好 Goodmorning
继续走	继续走 goon walkon
继续做	继续做 goondoing
过一遍	过一遍 goover
上大学	上大学 gotocollege
统治者	统治者 governor ruler
格雷斯	格雷斯 Grace
逐渐地	逐渐地 gradually littlebylittle
语法的	语法的 grammatical
庄严的	庄严的 grand
伟大的	伟大的 grand great
隔一辈	隔一辈 grand
外孙女	外孙女 granddaughter
外祖父	外祖父 grandfather
外祖母	外祖母 grandmother
老奶奶	老奶奶 granny
感激的	感激的 grateful thankful
灰色的	灰色的 gray grey grey
灰白的	灰白的 gray grey pale
大堡礁	大堡礁 GreatBarrierReef
贪婪的	贪婪的 greedy
希腊人	希腊人 Greek
希腊语	希腊语 Greek
绿色的	绿色的 green
运动场	运动场 ground
一层楼	一层楼 groundfloor
警卫员	警卫员 guard
导游者	导游者 guide
六弦琴	六弦琴 guitar
体育馆	体育馆 gym
健身房	健身房 gym
半小时	半小时 halfanhour
半冬眠	半冬眠 halfhibernate
汉堡包	汉堡包 hamburger
手提包	手提包 handbag
传下去	传下去 handdown
交进来	交进来 handin
英俊的	英俊的 handsome
漂亮的	漂亮的 handsome pretty
清秀的	清秀的 handsome
艰难的	艰难的 hard
努力地	努力地 hard
剧烈地	剧烈地 hard
猛烈地	猛烈地 hard
几乎不	几乎不 hardly
勤劳的	勤劳的 hardworking
有害的	有害的 harmful poisonous
无害的	无害的 harmless
不喜欢	不喜欢 hate
患头痛	患头痛 haveaheadache
一会儿	一会儿 havearest inaminute presently while
吃早餐	吃早餐 havebreakfast
吃早饭	吃早饭 havebreakfast
不得不	不得不 havegotto haveto
吃午饭	吃午饭 havelunch
与无关	与无关 havenothingtodowith
有约会	有约会 haveon
服点药	服点药 havesomemedicine
吃晚饭	吃晚饭 havesupper
健康的	健康的 healthy well
把加热	把加热 heat
激烈的	激烈的 heated
脚后跟	脚后跟 heel
有益的	有益的 helpful useful
随便吃	随便吃 helponeselfto helpyourself
在这里	在这里 here
向这里	向这里 here
这儿有	这儿有 Here's
她自己	她自己 herself
躲藏处	躲藏处 hidingplace
储藏处	储藏处 hidingplace
高度地	高度地 highly
多层的	多层的 highrise
高层的	高层的 highrise
丘陵的	丘陵的 hilly
他自己	他自己 himself
后部的	后部的 hind
历史学	历史学 history
希特勒	希特勒 Hitler
等一等	等一等 holdon
憋住气	憋住气 holdone'sbreath
中空的	中空的 hollow
诚实的	诚实的 honest
正直的	正直的 honest
蜜乳液	蜜乳液 honeydewmilk
绝望的	绝望的 hopeless
无望的	无望的 hopeless
你好吗	你好吗 Howareyou
庞大的	庞大的 huge
人类的	人类的 human
幽默感	幽默感 humour
饥饿的	饥饿的 hungry
冰淇淋	冰淇淋 icecream
是不是	是不是 if
不健康	不健康 ill
想象力	想象力 imagination
我就来	我就来 I'mcoming
快速的	快速的 immediate
马上的	马上的 immediate
在里面	在里面 in within
低声地	低声地 inalowvoice
小事件	小事件 incident
使倾斜	使倾斜 incline
真正地	真正地 indeed really truly
独立的	独立的 independent separate
印度的	印度的 Indian
间接的	间接的 indirect
在屋里	在屋里 indoors
工业的	工业的 industrial
用英语	用英语 inEnglish
受伤的	受伤的 injured wounded
受伤处	受伤处 injury
一生中	一生中 inlife
小旅馆	小旅馆 inn
内蒙古	内蒙古 InnerMongolia
有条理	有条理 inorder order
安宁的	安宁的 inpeace peaceful
公开地	公开地 inpublic
沉默地	沉默地 insilence
无声地	无声地 insilence
在空间	在空间 inspace
检查员	检查员 inspector
而不是	而不是 insteadof
研究所	研究所 institute
惊奇地	惊奇地 insurprise
关心的	关心的 interested
国际的	国际的 international
在空中	在空中 intheair overhead
在白天	在白天 intheday inthedaytime
在白昼	在白昼 inthedaytime
远距离	远距离 inthedistance
在当中	在当中 inthemiddleof
爱尔兰	爱尔兰 Ireland
铁制品	铁制品 iron
烫衣板	烫衣板 ironingboard
岛状物	岛状物 island
意大利	意大利 Italy
它自己	它自己 itself
它本身	它本身 itself
起重器	起重器 jack
千万顶	千万顶 jack
日本国	日本国 Japan
日本的	日本的 Japanese
日本语	日本语 Japanese
日本人	日本人 Japanese
吉普车	吉普车 jeep
犹太人	犹太人 Jew
约翰逊	约翰逊 Johnson
约翰西	约翰西 Johnsy
开玩笑	开玩笑 joke makefunof playajoke
审判员	审判员 judge
初级的	初级的 junior
等一下	等一下 justaminute
大袋鼠	大袋鼠 kangaroo
凯特的	凯特的 Kate's
作记录	作记录 keeparecord
饲养员	饲养员 keeper
看守人	看守人 keeper
不接近	不接近 keepoff
肯塔基	肯塔基 Kentucky
和蔼的	和蔼的 kind
友爱的	友爱的 kind
仁慈的	仁慈的 kind merciful
和善的	和善的 kind
幼儿园	幼儿园 kindergarten
实验室	实验室 lab laboratory
劳动力	劳动力 labor labour workforce
小伙子	小伙子 lad
不久前	不久前 lately
潜在的	潜在的 latent
潜伏的	潜伏的 latent
最近的	最近的 latest next
最新的	最新的 latest
法学家	法学家 lawyer
懒惰的	懒惰的 lazy
领导人	领导人 leader
领导的	领导的 leading
一张［	一张［ leaf
倾斜的	倾斜的 leaning
博学的	博学的 learned
学习者	学习者 learner
初学者	初学者 learner
最小的	最小的 least
最少的	最少的 least
最少地	最少地 least
剩余的	剩余的 leftover
剩下的	剩下的 leftover
把借给	把借给 lend lent
更少的	更少的 less
较少的	较少的 less
更少地	更少地 less
较少地	较少地 less
让进来	让进来 letin
水平线	水平线 level
使自由	使自由 liberate setfree
图书馆	图书馆 library
图书室	图书室 library
救生艇	救生艇 lifeboat
浅色的	浅色的 light
轻微地	轻微地 lightly slightly
有限的	有限的 limited
瘸着走	瘸着走 limp
生产线	生产线 line
仔细听	仔细听 listen
很少的	很少的 little
生动的	生动的 lively
活泼的	活泼的 lively
靠生活	靠生活 liveon liveon
活着的	活着的 living
起居室	起居室 livingroom sittingroom
当地的	当地的 local
地方的	地方的 local
孤独的	孤独的 lonely
荒凉的	荒凉的 lonely
长时间	长时间 long
极想念	极想念 long
长期的	长期的 longterm
看不起	看不起 lookdownupon
向上看	向上看 lookup
］查寻	］查寻 lookup
织布机	织布机 loom
松散的	松散的 loose
宽松的	宽松的 loose
发脾气	发脾气 loseone'stemper
嗓子哑	嗓子哑 loseone'svoice
降体重	降体重 loseweight
大声的	大声的 loud
响亮的	响亮的 loud
吵闹的	吵闹的 loud
可爱的	可爱的 lovely
好看的	好看的 lovely nice
发疯的	发疯的 mad
疯狂的	疯狂的 mad
华丽的	华丽的 magnificent
豪华的	豪华的 magnificent
邮递员	邮递员 mailman postman
大体上	大体上 mainly
主要地	主要地 mainly mostly
大部分	大部分 mainly massesof most mostly
较大的	较大的 major
大多数	大多数 majority massesof most
向猛冲	向猛冲 makeadivefor
做鬼脸	做鬼脸 makeaface makefaces
做苦脸	做苦脸 makeaface
犯错误	犯错误 makeamistake
交朋友	交朋友 makefriends
讲得通	讲得通 makesense
用造句	用造句 makesentenceswith
男性的	男性的 male
马利特	马利特 Mallet
管理人	管理人 manager
人造的	人造的 manmade
人工的	人工的 manmade
许多的	许多的 many most
许多人	许多人 many more most
男教师	男教师 master
最大量	最大量 maximum
一餐饭	一餐饭 meal
一顿饭	一顿饭 meal
意思是	意思是 mean meant
意味着	意味着 mean meant
纪念章	纪念章 medal
医学的	医学的 medical
医疗的	医疗的 medical
内科学	内科学 medicine
会议室	会议室 meetingroom
纪念物	纪念物 memorial monument
纪念碑	纪念碑 memorial monument
记忆力	记忆力 memory
存贮器	存贮器 memory
男厕所	男厕所 men'sroom
精神的	精神的 mental spiritual
脑力的	脑力的 mental
精神上	精神上 mentally
智力上	智力上 mentally
宽大的	宽大的 merciful
仅仅的	仅仅的 mere
只不过	只不过 merely
欢乐地	欢乐地 merrily
愉快地	愉快地 merrily
金属的	金属的 metallic
显微镜	显微镜 microscope
百万个	百万个 million
矿物质	矿物质 mineral
无机物	无机物 mineral
减去的	减去的 minus
未看见	未看见 miss
没看到	没看到 miss
弄错的	弄错的 mistaken
错误的	错误的 mistaken wrong
混合物	混合物 mixture
模特儿	模特儿 model
现代的	现代的 modern
星期一	星期一 Monday
放债者	放债者 moneylender
道德的	道德的 moral
道义的	道义的 moral
越来越	越来越 moreandmore
发霉的	发霉的 mouldy
美洲狮	美洲狮 mountainlion
多山的	多山的 mountainous
小胡子	小胡子 moustache
满口的	满口的 mouthful
朝前走	朝前走 moveon
挪过去	挪过去 moveover
莫扎特	莫扎特 Mozart
软湿的	软湿的 mud
使相乘	使相乘 multiply
木乃伊	木乃伊 mummy
杀人犯	杀人犯 murderer
低声说	低声说 murmur
博物馆	博物馆 museum
音乐的	音乐的 musical
音乐片	音乐片 musical
音乐家	音乐家 musician
一定是	一定是 must
必定是	必定是 must
我自己	我自己 myself
神秘的	神秘的 mysterious
拿破仑	拿破仑 Napoleon
狭窄的	狭窄的 narrow
国家的	国家的 national
民族的	民族的 national
本地人	本地人 native
本国人	本国人 native
本地的	本地的 native
本国的	本国的 native
自然界	自然界 natural nature
自然的	自然的 natural
天然的	天然的 natural
自然地	自然地 naturally
天然地	天然地 naturally
顽皮的	顽皮的 naughty
淘气的	淘气的 naughty
附近的	附近的 nearby
整洁的	整洁的 neat
熟练的	熟练的 neatly practised skilled
灵巧的	灵巧的 neatly smart
必需的	必需的 necessary
必要的	必要的 necessary
黑人的	黑人的 Negro
尼莉莎	尼莉莎 Nerissa
网状物	网状物 net
没关系	没关系 nevermind
不要紧	不要紧 nevermind
新泽西	新泽西 NewJersey
新西兰	新西兰 NewZealand
隔壁的	隔壁的 next
紧接的	紧接的 next
下一次	下一次 next
下一步	下一步 next
尼古丁	尼古丁 nicotine
外甥女	外甥女 niece
诺贝尔	诺贝尔 Nobel
高贵的	高贵的 noble
贵族的	贵族的 noble
没有人	没有人 nobody none
谁也不	谁也不 nobody
打招呼	打招呼 nod
嘈杂声	嘈杂声 noise
嘈杂的	嘈杂的 noisy
喧闹的	喧闹的 noisy
不停的	不停的 nonstop
正常的	正常的 normal
正规的	正规的 normal
北方的	北方的 north northern
北部的	北部的 northern
向北方	向北方 northward
根本不	根本不 notatall
笔记簿	笔记簿 notebook
注意到	注意到 notice
直到才	直到才 notuntil
十一月	十一月 November
不时地	不时地 nowandthen
保育员	保育员 nurse
疗养所	疗养所 nursinghome
坚果核	坚果核 nut
硬壳果	硬壳果 nut
明显的	明显的 obvious sharp
显著的	显著的 obvious
显然地	显然地 obviously
大洋洲	大洋洲 Oceania
办公室	办公室 office
官方的	官方的 official
正式的	正式的 official regular
可以行	可以行 okay
年老的	年老的 old
古老的	古老的 old
在时刻	在时刻 on
在农场	在农场 onafarm
不停地	不停地 onandon
在船上	在船上 onboard
接连地	接连地 oneafteranother
有一天	有一天 oneday
某一天	某一天 oneday
在度假	在度假 onholiday
洋葱头	洋葱头 onion
仅有的	仅有的 only
独立地	独立地 onone'sown
独自地	独自地 onone'sown
相反地	相反地 onthecontrary
在左边	在左边 ontheleft
在右边	在右边 ontheright
在途中	在途中 ontheway
在路上	在路上 ontheway
到上面	到上面 onto
开着的	开着的 open
开放的	开放的 open
开口的	开口的 open
动手术	动手术 operate
接线员	接线员 operator
对面的	对面的 opposite
相对的	相对的 opposite
相反的	相反的 opposite
口述的	口述的 oral
橙色的	橙色的 orange
桔色的	桔色的 orange
定货单	定货单 order
整齐的	整齐的 orderly
平常的	平常的 ordinary usual
要不然	要不然 orelse otherwise
组织者	组织者 organizer
另外的	另外的 other
其它的	其它的 other theothers
总应该	总应该 ought oughtto
我们的	我们的 our ours
户外的	户外的 outdoor
室外的	室外的 outdoor
在户外	在户外 outdoors
在野外	在野外 outdoors
外部的	外部的 outer
外面的	外面的 outer
够不着	够不着 outofone'sreach
看不见	看不见 outofsight
在外面	在外面 outside
在头上	在头上 overhead
猫头鹰	猫头鹰 owl
自己的	自己的 own
所有者	所有者 owner
所有制	所有制 ownership
太平洋	太平洋 Pacific
塞满的	塞满的 packed
满座的	满座的 packed
发工资	发工资 paid pay
痛苦的	痛苦的 painful
使痛的	使痛的 painful
痛苦地	痛苦地 painfully
绘画者	绘画者 painter
油画家	油画家 painter
水彩画	水彩画 painting
苍白的	苍白的 pale
薄煎饼	薄煎饼 pancake
控制板	控制板 panel
特殊的	特殊的 particular peculiar special
个别的	个别的 particular
部分地	部分地 partly
兼职的	兼职的 parttime
通行证	通行证 pass
不过问	不过问 passby
过路人	过路人 passenger passerby
下判决	下判决 passjudgement
昏过去	昏过去 passout
耐心的	耐心的 patient
和平的	和平的 peaceful
和平地	和平地 peacefully
安宁地	安宁地 peacefully
奇怪的	奇怪的 peculiar strange
铅笔盒	铅笔盒 pencilbox
青霉素	青霉素 penicillin
养老金	养老金 pension
百分之	百分之 percent
百分率	百分率 percentage
完美的	完美的 perfect
极好地	极好地 perfectly wonderfully
完美地	完美地 perfectly
表演者	表演者 performer
演奏者	演奏者 performer
个人的	个人的 personal
私人的	私人的 personal private
菲律宾	菲律宾 Philippines
打电话	打电话 phone ring ringup rung telephone
影印机	影印机 photocopier
摄影师	摄影师 photographer
物理的	物理的 physical
身体的	身体的 physical
体力上	体力上 physical
物理学	物理学 physics
钢琴家	钢琴家 pianist
图画书	图画书 picturebook
皮埃尔	皮埃尔 Pierre
飞行员	飞行员 pilot
粉红色	粉红色 pink
开拓者	开拓者 pioneer settler
输送管	输送管 pipe
平易的	平易的 plain
朴素的	朴素的 plain simple
玩游戏	玩游戏 play
运动者	运动者 player
弹钢琴	弹钢琴 playthepiano
舒适的	舒适的 pleasant
充足的	充足的 plentyof
诗体文	诗体文 poem
小数点	小数点 point
有毒的	有毒的 poisonous
警察局	警察局 policestation
政治的	政治的 political
政治家	政治家 politician
贫穷的	贫穷的 poor
可怜的	可怜的 poor wretched
不好的	不好的 poor
流行的	流行的 popstar
大众的	大众的 popstar
鲍西娅	鲍西娅 Portia
可能的	可能的 possible
可能地	可能地 possibly
明信片	明信片 postcard
广告画	广告画 poster
战后的	战后的 postwar
马铃薯	马铃薯 potato
有力的	有力的 powerful
强大的	强大的 powerful
软弱的	软弱的 powerless
发电站	发电站 powerstation
应用的	应用的 practical
精通的	精通的 practised
大草原	大草原 prairie
婴儿车	婴儿车 pram
宝贵的	宝贵的 precious
珍贵的	珍贵的 precious rare
更喜欢	更喜欢 prefer
在场的	在场的 present
出席的	出席的 present
俊俏的	俊俏的 pretty
无价的	无价的 priceless
极贵的	极贵的 priceless
打印机	打印机 printer
印刷术	印刷术 printing
很可能	很可能 probably
制作法	制作法 process
有希望	有希望 promise
有指望	有指望 promise
适当的	适当的 proper
本来的	本来的 proper
适当地	适当地 properly
自豪的	自豪的 proud
骄傲的	骄傲的 proud
骄傲地	骄傲地 proudly
自豪地	自豪地 proudly
公众的	公众的 public
公共的	公共的 public
公开的	公开的 public
出版社	出版社 publishinghouse
牵引力	牵引力 pull
抽水机	抽水机 pump
小学生	小学生 pupil
纯净的	纯净的 pure
使纯净	使纯净 purify
使洁净	使洁净 purify
贴广告	贴广告 putup
使迷惑	使迷惑 puzzle
使为难	使为难 puzzle
迷惑的	迷惑的 puzzled
困惑的	困惑的 puzzled troubled
金字塔	金字塔 pyramid
为争吵	为争吵 quarrelabout
一刻钟	一刻钟 quarter
安静的	安静的 quiet
平静的	平静的 quiet smooth
安静地	安静地 quietly
相当多	相当多 quiteafew
种族的	种族的 racial
放射物	放射物 radiation
无线电	无线电 radio
收音机	收音机 radio
放射性	放射性 radioactivity
一场雨	一场雨 rainfall
降雨量	降雨量 rainfall
使升高	使升高 raise
拉姆齐	拉姆齐 Ramsay
稀有的	稀有的 rare
相当地	相当地 rather
是而不	是而不 ratherthan
阅览室	阅览室 readingroom
有准备	有准备 ready
认识到	认识到 realise realize
意识到	意识到 realize
反叛者	反叛者 rebel
新近的	新近的 recent
近来的	近来的 recent
接待处	接待处 receptiondesk
接待员	接待员 receptionist
录音机	录音机 recorder
再循环	再循环 recycle recycling
红色的	红色的 red
红棕色	红棕色 reddishbrown
参考书	参考书 reference
规则的	规则的 regular
固定的	固定的 regular
规则地	规则地 regularly
相对性	相对性 relativity
宗教的	宗教的 religious
虔诚的	虔诚的 religious
剩余物	剩余物 remainder
异常的	异常的 remarkable unusual
通讯员	通讯员 reporter
共和国	共和国 republic
评论者	评论者 reviewer
评论家	评论家 reviewer
革命者	革命者 revolutionary
革命的	革命的 revolutionary
富裕的	富裕的 rich
有钱的	有钱的 rich
人力车	人力车 rickshaw
使摆脱	使摆脱 rid
成熟的	成熟的 ripe
起细浪	起细浪 ripple
罗伯特	罗伯特 Robert
鲁滨逊	鲁滨逊 Robinson
机器人	机器人 robot
大石头	大石头 rock
摇动的	摇动的 rocking wagging
玫瑰花	玫瑰花 rose
粗糙的	粗糙的 rough roughly
粗暴地	粗暴地 roughly
循环地	循环地 round
环形的	环形的 round
使集拢	使集拢 roundup
无礼的	无礼的 rude
粗鲁的	粗鲁的 rude
铃响环	铃响环 rung
自来水	自来水 runningwater
跑上去	跑上去 runup
跑过去	跑过去 runup
俄罗斯	俄罗斯 Russia
俄国人	俄国人 Russian
沙沙响	沙沙响 rustle
难过的	难过的 sad sorry upset
悲哀的	悲哀的 sad
忧愁的	忧愁的 sad
悲伤的	悲伤的 sad
难过地	难过地 sadly
悲哀地	悲哀地 sadly
伤心地	伤心地 sadly
痛心地	痛心地 sadly
安全的	安全的 safe
平安的	平安的 safe
售货员	售货员 salesman shopassistant
盐湖城	盐湖城 SaltLakeCity
含盐的	含盐的 salty
同一的	同一的 same
同样的	同样的 same
三明治	三明治 sandwich
旧金山	旧金山 SanFrancisco
星期六	星期六 Saturday
调味汁	调味汁 sauce
锯木厂	锯木厂 sawmill
向问好	向问好 sayhelloto
缺乏的	缺乏的 scarce
不足的	不足的 scarce
风景区	风景区 scenicspot
奖学金	奖学金 scholarship
科学的	科学的 scientific
科学家	科学家 scientist
苏格兰	苏格兰 Scotland
斯科特	斯科特 Scott
尖叫声	尖叫声 scream
荧光屏	荧光屏 screen
使坐下	使坐下 seat
使就座	使就座 seat
第二日	第二日 second
第二秒	第二秒 second
第二个	第二个 second
二手货	二手货 secondhand
用过的	用过的 secondhand
秘密的	秘密的 secret
隐蔽的	隐蔽的 secret
种子穗	种子穗 seedhead
塞纳河	塞纳河 Seine
较高的	较高的 senior
感觉到	感觉到 sense
传感器	传感器 sensor
分离的	分离的 separate
分离地	分离地 separately
单独地	单独地 separately
各自地	各自地 separately
严肃的	严肃的 serious severe
卷头发	卷头发 set
使爆炸	使爆炸 setfireto
使爆发	使爆发 setfireto
使燃烧	使燃烧 setonfire
放火烧	放火烧 setonfire
住宅区	住宅区 settlement settlement
移居者	移居者 settler
破旧的	破旧的 shabby
蹩脚的	蹩脚的 shabby
阴凉处	阴凉处 shade
遮光帘	遮光帘 shade
肤浅的	肤浅的 shallow
锋利的	锋利的 sharp
牧羊人	牧羊人 shepherd
使发光	使发光 shine
使发亮	使发亮 shine
使震惊	使震惊 shock
到商店	到商店 shop
营业员	营业员 shopassistant
射击声	射击声 shot
领出去	领出去 showout
害羞的	害羞的 shy
羞怯的	羞怯的 shy
夏洛克	夏洛克 Shylock
怕羞地	怕羞地 shyly
胆小地	胆小地 shyly
患病的	患病的 sick
生病的	生病的 sick
想呕吐	想呕吐 sick
恶心的	恶心的 sick
向侧面	向侧面 sideway
作手势	作手势 sign
沉默的	沉默的 silent
无声的	无声的 silent
丝织品	丝织品 silk
糊涂的	糊涂的 silly
愚蠢的	愚蠢的 silly stupid
类似的	类似的 similar
单纯的	单纯的 simple
简单的	简单的 simple
简易的	简易的 simple
纯朴的	纯朴的 simpleminded
简单地	简单地 simply
真诚地	真诚地 sincerely
新加坡	新加坡 Singapore
歌唱家	歌唱家 singer
单一的	单一的 single
单个的	单个的 single
坐起来	坐起来 situp
去滑冰	去滑冰 skating swimming
极瘦的	极瘦的 skinny
幻灯片	幻灯片 slide
使滑动	使滑动 slide
轻微的	轻微的 slight
微小的	微小的 slight tiny
轻蔑地	轻蔑地 slightly
微小地	微小地 slightly
细小地	细小地 slightly
细长的	细长的 slim
苗条的	苗条的 slim
悄悄走	悄悄走 slip
不聪明	不聪明 slow
慢慢地	慢慢地 slowly
聪敏的	聪敏的 smart
闻气味	闻气味 smell
史密斯	史密斯 Smith
吸烟者	吸烟者 smoker
光滑的	光滑的 smooth soft
打喷嚏	打喷嚏 sneeze
暴风雪	暴风雪 snowstorm
社会的	社会的 social
社交的	社交的 social
软饮料	软饮料 softdrink
使变软	使变软 soften
柔软地	柔软地 softly
固体的	固体的 solid
一部分	一部分 some
一些人	一些人 someothers
其他人	其他人 someothers
某东西	某东西 something
在某处	在某处 somewhere
分类室	分类室 sortingroom
结果是	结果是 sothat
听起来	听起来 sound
南方的	南方的 south southern
南部的	南部的 southern
苏联的	苏联的 Soviet
西班牙	西班牙 Spain
多余的	多余的 spare
发火花	发火花 sparkle
说话者	说话者 speaker
讲演者	讲演者 speaker
扬声器	扬声器 speaker
大声讲	大声讲 speakout
特别的	特别的 special
拼写法	拼写法 spelling
巨头鲸	巨头鲸 spermwhale
心灵的	心灵的 spiritual
吐唾沫	吐唾沫 spit
灿烂的	灿烂的 splendid
壮丽的	壮丽的 splendid
壮观的	壮观的 splendid
口语的	口语的 spoken
运动会	运动会 sport sportsmeet
向喷射	向喷射 spray
正方形	正方形 square
体育场	体育场 stadium
标准的	标准的 standard
盯着看	盯着看 stare stareat
起跑点	起跑点 startingpoint
出发点	出发点 startingpoint
不睡觉	不睡觉 stayup
稳定地	稳定地 steadily
稳固地	稳固地 steadily
平稳的	平稳的 steady
水蒸气	水蒸气 steam
险峻的	险峻的 steep
陡峭的	陡峭的 steep
脚步声	脚步声 step
逐步的	逐步的 stepbystep
逐渐的	逐渐的 stepbystep
踩油门	踩油门 steponthegas
小树枝	小树枝 stick
寂静的	寂静的 still
静止的	静止的 still
记秒表	记秒表 stopwatch
暴风雨	暴风雨 storm
故事书	故事书 storybook
陌生的	陌生的 strange
陌生人	陌生人 stranger
严格的	严格的 strict
强壮的	强壮的 strong
坚强的	坚强的 strong
坚固的	坚固的 strong
工作室	工作室 studio workroom
演播室	演播室 studio
成功的	成功的 successful
成功地	成功地 successfully
这样的	这样的 such
那样的	那样的 such
突然的	突然的 sudden
突然地	突然地 suddenly
苏伊士	苏伊士 Suez
合适的	合适的 suitable
适宜的	适宜的 suitable
使适合	使适合 suitto
使适应	使适应 suitto
晒黑的	晒黑的 sunburnt
星期日	星期日 Sunday
太阳镜	太阳镜 sunglasses
睛朗的	睛朗的 sunny
贮藏量	贮藏量 supply
确信的	确信的 sure
幸存者	幸存者 survival
运动衣	运动衣 sweater
套头衫	套头衫 sweater
瑞典人	瑞典人 Swede
亲切地	亲切地 sweetly
游泳池	游泳池 swimmingpool
开电灯	开电灯 switchon
交响乐	交响乐 symphony
乒乓球	乒乓球 tabletennis
看一下	看一下 takealookat
使吃惊	使吃惊 takebysurprise
吃食物	吃食物 takefood
别着急	别着急 takeiteasy
别紧张	别紧张 takeiteasy
坐火车	坐火车 takethetrain
驯服的	驯服的 tame
录音带	录音带 tape
技术的	技术的 technical
技能的	技能的 technical
工艺的	工艺的 technical
工艺学	工艺学 technology
电报机	电报机 telegraph
电话机	电话机 telephone
望远镜	望远镜 telescope
电视机	电视机 television TVset
脆弱的	脆弱的 tender
好几万	好几万 tensofthousands
极坏的	极坏的 terrible
使恐怖	使恐怖 terrify
教科书	教科书 textbook
感谢的	感谢的 thankful
没什么	没什么 That'sallright
北冰洋	北冰洋 theArcticOcean
印度洋	印度洋 theIndianOcean
他们的	他们的 their
她们的	她们的 their
它们的	它们的 their theirs
前两年	前两年 thelasttwoyears
麻烦事	麻烦事 thematter
相对论	相对论 TheoryofRelativity
前几天	前几天 theotherday
在那儿	在那儿 there
往那儿	往那儿 there
科学馆	科学馆 theScienceMuseum
颐和园	颐和园 theSummerPalace
市议会	市议会 theTownCouncil
联合国	联合国 theUnitedNations UnitedNations
茂密地	茂密地 thickly
葱葱地	葱葱地 thickly
思想家	思想家 thinker
干燥的	干燥的 thirsty
口渴的	口渴的 thirsty
彻底的	彻底的 thorough
沉思地	沉思地 thoughtfully
向扔去	向扔去 throwat
把扔给	把扔给 throwto
星期四	星期四 Thursday
牢固地	牢固地 tightly
极小的	极小的 tiny
使疲倦	使疲倦 tire
使厌倦	使厌倦 tire
使疲劳	使疲劳 tire
疲劳的	疲劳的 tired
老实说	老实说 tobehonest
洗手间	洗手间 toilet
西红柿	西红柿 tomato
在明天	在明天 tomorrow
最高处	最高处 top
玳瑁壳	玳瑁壳 tortoiseshell
强硬的	强硬的 tough
粗暴的	粗暴的 tough
旅游业	旅游业 tourism
旅行者	旅行者 tourist
观光者	观光者 tourist
拖拉机	拖拉机 tractor
训练者	训练者 trainer
训练人	训练人 trainer
把译成	把译成 translateinto
恶作剧	恶作剧 trick
不安的	不安的 troubled upset
讨厌的	讨厌的 troublesome
逃学者	逃学者 truant
真实地	真实地 truly
试试看	试试看 tryon
选拔赛	选拔赛 tryout
星期二	星期二 Tuesday
变绿色	变绿色 turngreen
求救于	求救于 turnto
求助于	求助于 turnto
求教于	求教于 turnto
电视剧	电视剧 TVplay
拨弦声	拨弦声 twang
第十二	第十二 twelfth
第二十	第二十 twentieth
二十四	二十四 twentyfour
双胞胎	双胞胎 twins
打字机	打字机 typewriter
打字员	打字员 typist
丑陋的	丑陋的 ugly
难看的	难看的 ugly
不能的	不能的 unable
不会的	不会的 unable
不确定	不确定 uncertain
向下面	向下面 under
地下的	地下的 underground
专一的	专一的 undivided
专心的	专心的 undivided
脱衣服	脱衣服 undress
琐碎的	琐碎的 unimportant
联合会	联合会 union
统一的	统一的 united
联合的	联合的 united
如果不	如果不 unless
失败的	失败的 unsuccessful
原样的	原样的 untouched
奇异的	奇异的 unusual
向上面	向上面 up
来回地	来回地 upanddown
在楼上	在楼上 upstairs
往楼上	往楼上 upstairs
楼上的	楼上的 upstairs
正在干	正在干 upto
向上的	向上的 upward
往上的	往上的 upward
乌拉尔	乌拉尔 Ural
有用的	有用的 useful valuable
无用的	无用的 useless
动脑筋	动脑筋 useone'shead
通常的	通常的 usual
自负的	自负的 vain
值钱的	值钱的 valuable
重要性	重要性 value
瓦格斯	瓦格斯 Vargas
威尼斯	威尼斯 Venice
恰好的	恰好的 very
视频的	视频的 video
维也纳	维也纳 Vienna
观看者	观看者 viewer
葡萄树	葡萄树 vine
暴力的	暴力的 violent
小提琴	小提琴 violin
访问者	访问者 visitor
参观者	参观者 visitor
词汇表	词汇表 vocabulary
说话声	说话声 voice
摆动的	摆动的 wagging
服务员	服务员 waiter
威尔士	威尔士 Wales
步行者	步行者 walker
竞走者	竞走者 walker
暖和的	暖和的 warm
温暖的	温暖的 warm
热情的	热情的 warm warmhearted
亲切的	亲切的 warm warmhearted
热血的	热血的 warmblooded
使暖和	使暖和 warmup
华盛顿	华盛顿 Washington
废弃的	废弃的 waste
峰火台	峰火台 watchtower
蜡状物	蜡状物 wax
虚弱的	虚弱的 weak
富有的	富有的 wealthy
气象员	气象员 weatherman
织布工	织布工 weaver
编织者	编织者 weaver
星期三	星期三 Wednesday
每周的	每周的 weekly
身体好	身体好 well
出名的	出名的 wellknown
韦斯利	韦斯利 Wesley
西方的	西方的 west western
西部的	西部的 western
西方人	西方人 westerner
多雨的	多雨的 wet
怎么样	怎么样 what
在哪里	在哪里 where
往哪里	往哪里 where
哪一个	哪一个 which
和同时	和同时 while
口哨声	口哨声 whistle
打口哨	打口哨 whistle
白色的	白色的 white
怎么啦	怎么啦 why
宽阔的	宽阔的 wide
广泛的	广泛的 wide
广阔地	广阔地 wide widely
全部地	全部地 wide
广泛地	广泛地 widely
野生的	野生的 wild
疯狂地	疯狂地 wildly
急切地	急切地 wildly
乐意地	乐意地 willingly
有风的	有风的 windy
风大的	风大的 windy
获胜者	获胜者 winner
英明的	英明的 wise
在一起	在一起 with
轻易地	轻易地 withease
残忍地	残忍地 withoutmercy
不知道	不知道 wonder
精彩的	精彩的 wonderful
精彩地	精彩地 wonderfully
伐木工	伐木工 woodcutter
木制的	木制的 wooden
制订出	制订出 workout
有旧的	有旧的 worn
穿坏的	穿坏的 worn
焦虑的	焦虑的 worried
烦恼的	烦恼的 worried
更坏的	更坏的 worse
更差的	更差的 worse
最坏的	最坏的 worst
值得的	值得的 worth
相称的	相称的 worthy
悲惨的	悲惨的 wretched
写信给	写信给 writeto
邪恶的	邪恶的 wrong
不对的	不对的 wrong
X射线	X射线 Xray
年轻的	年轻的 young
年幼的	年幼的 young
你们的	你们的 your yours
你自己	你自己 yourself
动物园	动物园 zoo
算盘	算盘 abacus
一盆	一盆 abasinof
艾贝	艾贝 Abe
能力	能力 ability energy
才能	才能 ability
能够	能够 able beabletodosth can
一瓶	一瓶 abottleof
大约	大约 about orso
周围	周围 about surrounding
关于	关于 about on
上面	上面 above top upside
首先	首先 aboveall firstofall foronething
首要	首要 aboveall
缺席	缺席 absence
缺乏	缺乏 absence lack
不在	不在 absence
吸收	吸收 absorb
吸引	吸引 absorb attract
口音	口音 accent
音调	音调 accent
承认	承认 accept admit recognize
接受	接受 accept
答应	答应 accept makeapromise permission promise
事故	事故 accident
按照	按照 according
根据	根据 according accordingto root
报道	报道 account
叙述	叙述 account description recite
痛痛	痛痛 ache
疼痛	疼痛 ache hurt pain
药房	药房 achemist'sshop
达到	达到 achieve cometo go reach
取得	取得 achieve get
功绩	功绩 achievement
成就	成就 achievement success
横过	横过 across
穿过	穿过 across cross cross runacross through
对面	对面 across
表演	表演 act actout perform performance play
演出	演出 act performance putonperformances
条例	条例 act
行动	行动 act action
做事	做事 act
担任	担任 actas
充当	充当 actas
行为	行为 action deed
活动	活动 action activity movement
一杯	一杯 acupof
公元	公元 AD
增加	增加 add bringin increase raise
添加	添加 add
住址	住址 address
总计	总计 addupto inall
钦佩	钦佩 admire
赞美	赞美 admire
羡慕	羡慕 admire envy
接纳	接纳 admit
容纳	容纳 admit
采纳	采纳 adopt
一滴	一滴 adropof
推进	推进 advance pushon
促进	促进 advance speed
前进	前进 advance forward march
优点	优点 advantage virtue
好处	好处 advantage benefit
冒险	冒险 adventure
奇遇	奇遇 adventure
副词	副词 adverb
广告	广告 advertisement poster
忠告	忠告 advice
劝告	劝告 advice
建议	建议 advice suggest suggestion
飞机	飞机 aeroplane aircraft plane
一些	一些 afew anumberof any bit some
事情	事情 affair matter thing
事件	事件 affair event thing
影响	影响 affect effect influence leadto
感动	感动 affect
提供	提供 afford bringout offer provide
买花	买花 afford
害怕	害怕 afraid beafraid beafraidof fear
担心	担心 afraid worry worryabout
非洲	非洲 Africa
在后	在后 after
后来	后来 after afterward afterwards byandby later then
以后	以后 after afterward byandby infuture later
之后	之后 after later
毕竟	毕竟 afterall
终究	终究 afterall
不久	不久 afterawhile byandby inashortwhile later presently shortly soon
课后	课后 afterclass
下午	下午 afternoon noon pm
午后	午后 afternoon pm
反对	反对 against goagainst oppose
对着	对着 against
汽油	汽油 agasstation gas petrol
年龄	年龄 age
以前	以前 ago atonetime before onceuponatime
许多	许多 agood alot alotof anumberof dozensof greatmany heap lot lotsof more much scoresof
很多	很多 agood alotof greatmany lot lotsof
大量	大量 agreatdeal alot alotof heap lotsof mass plenty scoresof
同意	同意 agree nod permission will yes
应允	应允 agree
赞成	赞成 agree
契约	契约 agreement
协定	协定 agreement
一致	一致 agreement
商定	商定 agreeon
决定	决定 agreeon decide decision determination determine fix makeupone'smind turnin
农业	农业 agriculture
农艺	农艺 agriculture
一群	一群 agroupof herd troop
一组	一组 agroupof
啊哈	啊哈 aha
向前	向前 ahead along forward
优于	优于 aheadof
帮助	帮助 aid favour favor help
援助	援助 aid
瞄准	瞄准 aim takeaim
目标	目标 aim goal object
目的	目的 aim order purpose
空气	空气 air atmosphere
大气	大气 air atmosphere
一种	一种 akindof asortof
一类	一类 akindof
艾尔	艾尔 Al
哎呀	哎呀 alas Dearme oh well
一点	一点 alittle bit bitbybit
少量	少量 alittle
活着	活着 alive live
全部	全部 all through
全体	全体 all
一直	一直 allalong allthetime always
始终	始终 allalong allthetime
整夜	整夜 allnightlong
终生	终生 allone'slife
到处	到处 allover around everywhere hereandthere
结束	结束 allover complete end endup finish over
遍及	遍及 allover over throughout
允许	允许 allow permission permission permit
准许	准许 allow
行了	行了 allright
好吧	好吧 allright
好了	好了 allright
仍然	仍然 allthesame however still yet
还是	还是 allthesame or
几乎	几乎 almost nearly
独自	独自 alone
沿着	沿着 along
顺着	顺着 along
已经	已经 already
虽然	虽然 although though
完全	完全 altogether atall quilt
总共	总共 altogether
总是	总是 always ever
永远	永远 always ever forever
美国	美国 America theStates theUnitedStates
美洲	美洲 America
刚才	刚才 amomentago just justnow
总数	总数 amount
数值	数值 amount
娱乐	娱乐 amuse amusement fun
逗乐	逗乐 amuse tickle
一个	一个 an one
祖宗	祖宗 ancestor
祖先	祖先 ancestor
等等	等等 andsoon etc
晚报	晚报 aneveningpaper
愤怒	愤怒 anger
发怒	发怒 anger
动物	动物 animal creature
牲畜	牲畜 animal
安妮	安妮 Annie
宣告	宣告 announce
宣布	宣布 announce declare
发表	发表 announce
通告	通告 announcement
通知	通知 announcement inform information instruct notice
再一	再一 another
别的	别的 another else other
回答	回答 answer reply
答复	答复 answer reply
回信	回信 answer
答案	答案 answer key
蚂蚁	蚂蚁 ant
蚜虫	蚜虫 antcow
蚁牛	蚁牛 antcow
鹿角	鹿角 antler
若干	若干 anumberof some
什么	什么 any what
一对	一对 apairof couple pair
一双	一双 apairof pair
一副	一副 apairof service
除去	除去 apartfrom
一伙	一伙 apartyof
一批	一批 apartyof
一张	一张 apieceof
一片	一片 apieceof
一块	一块 apieceof
一堆	一堆 apileof heap
名胜	名胜 aplaceofinterest
道歉	道歉 apologize apology
谢罪	谢罪 apologize
认错	认错 apology
出现	出现 appear appearance arise occur takeplace turnup
显得	显得 appear look
好像	好像 appear though look
露面	露面 appearance
苹果	苹果 apple
申请	申请 application
欣赏	欣赏 appreciate enjoyment
感激	感激 appreciate owe
四月	四月 April
建筑	建筑 architecture build
面积	面积 area
地点	地点 area place spot
区域	区域 area district zone
地面	地面 area floor ground land
地区	地区 area district region
争论	争论 argue argument debate
辩论	辩论 argue argument debate discussion
论据	论据 argument
升起	升起 arise rise risen
算术	算术 arithmetic
手臂	手臂 arm
胳膊	胳膊 arm
军队	军队 army troop
唤醒	唤醒 arouse awake wakeup
引起	引起 arouse attract cause create setfireto
激起	激起 arouse
整理	整理 arrange arrangement clearup
分类	分类 arrange
排列	排列 arrange
安排	安排 arrange arrangement settle
筹备	筹备 arrange arrangement
逮捕	逮捕 arrest
拘捕	拘捕 arrest
到来	到来 arrival
到达	到达 arrival arrive get getto reach turnup
来到	来到 arrive come
艺术	艺术 art
美术	美术 art
文章	文章 article
论文	论文 article paper
冠词	冠词 article
由于	由于 as asaresult becauseof nowthat since thanksto
因为	因为 as because becauseof
作为	作为 as
其实	其实 asamatteroffact
结果	结果 asaresult effect result
因此	因此 asaresult so therefore
相同	相同 asas
一套	一套 asetof service set suit
灰烬	灰烬 ash
惭愧	惭愧 ashamed
害臊	害臊 ashamed
近路	近路 ashortcut
捷径	捷径 ashortcut
亚洲	亚洲 Asia
好象	好象 asif seem
好似	好似 asif though
请求	请求 ask askfor askforsth beg pray request
要求	要求 ask callfor demand desire request require requirement
询问	询问 askfor
向要	向要 askfor askforsth
熟睡	熟睡 asleep
只要	只要 aslongas soasto solongas
助手	助手 assistant mate
助理	助理 assistant
一就	一就 assoonas
惊讶	惊讶 astonishment
既也	既也 aswellas
根本	根本 atall
全然	全然 atall
每次	每次 atatime
一次	一次 atatime once
起先	起先 atfirst
最后	最后 atlast attheend finally intheend last next
终于	终于 atlast finally intheend
至少	至少 atleast
起码	起码 atleast
夜里	夜里 atnight
晚上	晚上 atnight evening
中午	中午 atnoon noon
原子	原子 atom
立刻	立刻 atonce inaminute innotime rightaway rightnow shortly
马上	马上 atonce rightnow
自费	自费 atone'sownexpense
曾经	曾经 atonetime ever
目前	目前 atpresent
现在	现在 atpresent now nowadays present thesedays today
进攻	进攻 attack
攻击	攻击 attack
袭击	袭击 attack comeat
试图	试图 attempt seek try
尝试	尝试 attempt
出席	出席 attend
参加	参加 attend enter join joinin takepartin
看护	看护 attend
照料	照料 attend care lookafter takecareof tend
服侍	服侍 attend
注意	注意 attention care mind notice payattentionto
关心	关心 attention care carefor mind thinkof
起初	起初 atthebeginningof
开始	开始 atthebeginningof begin beginning first opening setout start
尽头	尽头 attheend
最迟	最迟 atthelatest
至迟	至迟 atthelatest
支配	支配 atthemercyof control
摆布	摆布 atthemercyof
至多	至多 atthemost
同时	同时 atthesametime meanwhile
然而	然而 atthesametime however though yet
态度	态度 attitude manner
看法	看法 attitude opinion view
八月	八月 August
伯母	伯母 aunt
舅母	舅母 aunt
作家	作家 author writer
作者	作者 author writer
秋天	秋天 autumn
秋季	秋季 autumn fall
平均	平均 average onaverage
避免	避免 avoid
回避	回避 avoid
躲开	躲开 avoid
离开	离开 away getout goaway leave moveaway off out
远离	远离 away byawayfrom farfrom
婴儿	婴儿 baby
后面	后面 back
向后	向后 back backward
背部	背部 back
背脊	背脊 back
退后	退后 back
后院	后院 backyard
坏的	坏的 bad
非常	非常 badly extra extremely greatly highly much so such very verymuch
提包	提包 bag
口袋	口袋 bag
书包	书包 bag
袋子	袋子 bag
行李	行李 baggage luggage pack
平衡	平衡 balance
舞会	舞会 ball
气球	气球 balloon
竹子	竹子 bamboo
禁止	禁止 ban forbid
禁令	禁令 ban
香蕉	香蕉 banana
银行	银行 bank
栅栏	栅栏 bar fence
议价	议价 bargain
吠叫	吠叫 bark
基础	基础 base
基地	基地 base
水盆	水盆 basin
脸盆	脸盆 basin
篮子	篮子 basket
篓子	篓子 basket
篮球	篮球 basketball
球拍	球拍 bat
蝙蝠	蝙蝠 bat
洗澡	洗澡 bath
澡盆	澡盆 bath
浴室	浴室 bath bathroom
冲洗	冲洗 bathe develop
洗浴	洗浴 bathe
游泳	游泳 bathe goswimming haveaswim skating swimming swim
澡堂	澡堂 bathroom
战役	战役 battle campaign
会战	会战 battle
战斗	战斗 battle fight
战场	战场 battlefield
海湾	海湾 bay gulf
刺刀	刺刀 bayonet
成为	成为 be become get go
即将	即将 beaboutto
海滩	海滩 beach
河滩	河滩 beach
恐怕	恐怕 beafraid
寻找	寻找 beafter inone'ssearchof insearchof lookfor search
寻求	寻求 beafter inone'ssearchof
横梁	横梁 beam
豆腐	豆腐 beancurd
担忧	担忧 beanxiousabout fear
熊国	熊国 BearCountry
胡须	胡须 beard
跳动	跳动 beat beat
敲打	敲打 beat strike
打胜	打胜 beat
打赢	打赢 beat
打死	打死 beattodeath
美丽	美丽 beauty
美人	美人 beauty
当心	当心 becareful lookout mind
小心	小心 becareful care
变得	变得 become get turinto
覆盖	覆盖 becoveredwith cover
铺盖	铺盖 bedclothes
卧室	卧室 bedroom
蜜蜂	蜜蜂 bee
牛肉	牛肉 beef
蜂箱	蜂箱 beehive hive
啤酒	啤酒 beer
适合	适合 befitfor fit fitinwith suit
胜任	胜任 befitfor
喜欢	喜欢 befondof carefor delight enjoy like love
爱好	爱好 befondof goinfor
很快	很快 beforelong innotime soon
恳求	恳求 beg
乞讨	乞讨 beg
开端	开端 beginning first origin
起源	起源 beginning origin root
善于	善于 begoodat goodat
擅长	擅长 begoodat
生物	生物 being creature
恋爱	恋爱 beinlovewith
迟到	迟到 belatefor late
相信	相信 belief believe believein dependon trust
信任	信任 belief believein trust
信念	信念 belief faith
信仰	信仰 belief faith
认为	认为 believe consider insist regardas think
风箱	风箱 bellows
属于	属于 belong belongto datefrom
附属	附属 belong
沉思	沉思 belostinthought
向下	向下 below down downward
腰带	腰带 belt
已婚	已婚 bemarried
长凳	长凳 bench
弯曲	弯曲 bend
利益	利益 benefit
得益	得益 benefit
弯的	弯的 bent
进行	进行 beon carryout held hold
展览	展览 beonshow exhibition
高兴	高兴 bepleased delight happy joy pleasure
自豪	自豪 beproudof pride
柏林	柏林 Berlin
就坐	就坐 beseated takeone'sseat
坐下	坐下 beseated haveaseat takeaseat
靠近	靠近 beside by close near nextto
还有	还有 besides
此外	此外 besides
打赌	打赌 bet
贝蒂	贝蒂 Betty
值得	值得 beworth
做的	做的 beworth
超出	超出 beyond
圣经	圣经 Bible theBible
大的	大的 big large
帐单	帐单 bill check
法案	法案 bill
议案	议案 bill
纸币	纸币 bill note
十亿	十亿 billion
百亿	百亿 billion
无数	无数 billion
禽类	禽类 bird
鸟笼	鸟笼 birdcage cage
出生	出生 birth born
诞生	诞生 birth
生日	生日 birthday
饼干	饼干 biscuit
主教	主教 bishop
渐次	渐次 bitbybit
苦的	苦的 bitter
黑板	黑板 blackboard
铁匠	铁匠 blacksmith
责备	责备 blame criticize scold
责怪	责怪 blame
谴责	谴责 blame
毛毯	毛毯 blanket carpet
毯子	毯子 blanket
出血	出血 bleed
流血	流血 bleed
保佑	保佑 bless
祝福	祝福 bless
瞎的	瞎的 blind
大块	大块 block
阻塞	阻塞 block choke
阻挡	阻挡 block holdup
开花	开花 bloom
打击	打击 blow hit shock
爆炸	爆炸 blow breakout explode
爆裂	爆裂 blow burst
刮走	刮走 blowaway
吹走	吹走 blowaway
蓝色	蓝色 blue
木板	木板 board plank
小船	小船 boat
鲍勃	鲍勃 Bob
身体	身体 body
尸体	尸体 body
躯体	躯体 body
健身	健身 bodybuilding
健美	健美 bodybuilding
沸腾	沸腾 boil
炸弹	炸弹 bomb
骨头	骨头 bone
书籍	书籍 book
书签	书签 bookmark
书商	书商 bookseller
书店	书店 bookstore
边缘	边缘 border edge
边界	边界 border
厌烦	厌烦 bore
借用	借用 borrow makeuseof
领班	领班 boss
老板	老板 boss
植物	植物 botany plant
两者	两者 both
两人	两人 both
双方	双方 both
两个	两个 bothand double
既又	既又 bothand
打扰	打扰 bother disturb interrupt
扰乱	扰乱 bother disturb
麻烦	麻烦 bother trouble
瓶子	瓶子 bottle
底部	底部 bottom
末端	末端 bottom
弹起	弹起 bounce
跳跃	跳跃 bounce leap
鞠躬	鞠躬 bow
屈服	屈服 bow givein
箱子	箱子 box case chest
盒子	盒子 box case chest
匣子	匣子 box
拳击	拳击 box boxing
男孩	男孩 boy
支架	支架 brace
脑子	脑子 brain
脑力	脑力 brain
智能	智能 brain
刹车	刹车 brake
制动	制动 brake
枝条	枝条 branch
支流	支流 branch creek
部门	部门 branch department section
勇敢	勇敢 bravery
大胆	大胆 bravery
面包	面包 bread
终止	终止 break stop
中断	中断 break
脱离	脱离 breakawayfrom
打破	打破 breakawayfrom
分解	分解 breakdown breakup
早餐	早餐 breakfast
早饭	早饭 breakfast
闯入	闯入 breakinto
打断	打断 breakoff interrupt
折断	折断 breakoff
发生	发生 breakout comeabout happen occur takeplace
腐蚀	腐蚀 breakup
胸膛	胸膛 breast
胸部	胸部 breast chest
呼吸	呼吸 breath breathe
气息	气息 breath
砖块	砖块 brick
带来	带来 bring
拿来	拿来 bring
引人	引人 bringin
取出	取出 bringout out takeout
推出	推出 bringout
教育	教育 bringup educate education
培养	培养 bringup education train
英国	英国 Britain England
宽的	宽的 broad
广播	广播 broadcast
播音	播音 broadcast
小河	小河 brook creek stream
扫帚	扫帚 broom
兄弟	兄弟 brother
布朗	布朗 Brown
褐色	褐色 brown
棕色	棕色 brown
刷子	刷子 brush
画笔	画笔 brush
铲斗	铲斗 bucket
臭虫	臭虫 bug
虫子	虫子 bug
建设	建设 build construction
建立	建立 build establish form found setup
房屋	房屋 building housing
布尔	布尔 Bull
子弹	子弹 bullet
枪弹	枪弹 bullet
公报	公报 bulletin
公告	公告 bulletin
撞击	撞击 bump
担子	担子 burden load
负担	负担 burden
劳累	劳累 burden
埋葬	埋葬 burial bury
燃烧	燃烧 burn
烧伤	烧伤 burn
灼伤	灼伤 burn
烧光	烧光 burndown
炸破	炸破 burst
灌木	灌木 bush
短树	短树 bush
事务	事务 business
商业	商业 business merchant trade trade
生意	生意 business
繁忙	繁忙 busy
但是	但是 but though
可是	可是 but however
除了	除了 but
黄油	黄油 butter
钮扣	钮扣 button
系住	系住 button
购买	购买 buy
在旁	在旁 by by
经过	经过 by by course goby pass passby past
偶然	偶然 byaccident bychance occasionally
汽车	汽车 car car
日间	日间 byday
再会	再会 byebye goodbye
用手	用手 byhand
乘船	乘船 bysea
附近	附近 bythesideof nearby
旁边	旁边 bythesideof side
轮船	轮船 ship ship
餐馆	餐馆 cafe
蛋糕	蛋糕 cake
计算	计算 calculate compute count
称呼	称呼 call
呼唤	呼唤 call
叫喊	叫喊 call cry
电话	电话 call phone phonecall telephone
访问	访问 callat callon payavisit visit
去取	去取 callfor fetch
去接	去接 callfor
号召	号召 callfor
召来	召来 callin
召集	召集 callin
拜访	拜访 callon saw see seen visit
平静	平静 calm
沉着	沉着 calm
镇定	镇定 calm
热卡	热卡 calorie
剑桥	剑桥 Cambridge
骆驼	骆驼 camel
野营	野营 camp camp
运动	运动 campaign game movement sport
可以	可以 can may might OK okay
可能	可能 can may might perhaps possibility
罐头	罐头 can tin
运河	运河 canal
沟渠	沟渠 canal channel
水道	水道 canal channel
癌症	癌症 cancer
蜡烛	蜡烛 candle
手杖	手杖 cane
不能	不能 can't
帽子	帽子 cap hat
盖子	盖子 cap cover lid
首都	首都 capital
省会	省会 capital
船长	船长 captain
捕获	捕获 capture
夺取	夺取 capture seize
卡片	卡片 card
名片	名片 card
保护	保护 care protect
留心	留心 care
谨慎	谨慎 care
照顾	照顾 carefor lookafter takecareof
粗心	粗心 careless
卡尔	卡尔 Carl
颂歌	颂歌 carol
地毯	地毯 carpet
运送	运送 carry carry ship
手提	手提 carry
肩挑	肩挑 carry
刊登	刊登 carry
搬运	搬运 carry move
携带	携带 carry
夺走	夺走 carryoff
开展	开展 carryout
执行	执行 carryout
实现	实现 carryout cometrue realise realize realize
马车	马车 cart
火车	火车 cart train
雕刻	雕刻 carve
患者	患者 case
投掷	投掷 cast shoot throw
撒网	撒网 castanet
城堡	城堡 castle
蓖麻	蓖麻 castor
抓住	抓住 catch catchholdof getholdof grasp hold snatch takeholdof
接住	接住 catch
捉住	捉住 catch
赶上	赶上 catch catchupwith
着凉	着凉 takecold cold
伤风	伤风 takecold catchacold haveacold
感冒	感冒 catchacold cold
着火	着火 catchfire onfire
看到	看到 catchsightof see
发现	发现 catchsightof comeacross discover discovery find found findout
追上	追上 catchupwith
超过	超过 catchupwith over pass
家畜	家畜 cattle
原因	原因 cause reason
起因	起因 cause
山洞	山洞 cave
岩洞	岩洞 cave
顶棚	顶棚 ceiling
庆祝	庆祝 celebrate celebration
公墓	公墓 cemetery
墓地	墓地 cemetery churchyard
公分	公分 centimetre
厘米	厘米 centimetre
中心	中心 centre
中央	中央 centre
世纪	世纪 century
百年	百年 century
仪式	仪式 ceremony
典礼	典礼 ceremony
某种	某种 certain
一定	一定 certainly surely
是的	是的 certainly yes
当然	当然 certainly ofcourse surely
锁链	锁链 chain
椅子	椅子 chair
主席	主席 chairman
议长	议长 chairman
会长	会长 chairman
粉笔	粉笔 chalk
挑战	挑战 challenge
冠军	冠军 champion
机会	机会 chance opportunity
改变	改变 change
兑换	兑换 change
变化	变化 change
零钱	零钱 change
找头	找头 change
用换	用换 changefor
海峡	海峡 channel strait
水渠	水渠 channel
特性	特性 character
性格	性格 character
汉字	汉字 character
字体	字体 character
人物	人物 character
角色	角色 character part role
木炭	木炭 charcoal
价钱	价钱 charge
主管	主管 charge inchargeof
承担	承担 charge
查利	查利 Charlie
魅力	魅力 charm
地图	地图 chart map
图表	图表 chart
聊天	聊天 chat talk
闲谈	闲谈 chat
廉价	廉价 cheap
便宜	便宜 cheap
骗子	骗子 cheat impostor
检查	检查 check examination examine goover inspect inspection review test
核对	核对 check
支票	支票 check cheque check
查明	查明 checkout findout
结帐	结帐 checkout
面颊	面颊 cheek
脸蛋	脸蛋 cheek
欢呼	欢呼 cheer
高呼	高呼 cheer shout
喝采	喝采 cheer clap
乳酪	乳酪 cheese
干酪	干酪 cheese
化学	化学 chemical chemistry
酸雨	酸雨 chemicalrain
樱桃	樱桃 cherry
栗子	栗子 chestnut
咀嚼	咀嚼 chew
小鸡	小鸡 chick chicken
鸡肉	鸡肉 chicken
首长	首长 chief
头子	头子 chief
首领	首领 chief
小孩	小孩 child
儿童	儿童 child
幼年	幼年 childhood
童年	童年 childhood
乐声	乐声 chime
烟筒	烟筒 chimney
烟囱	烟囱 chimney
中国	中国 China
汉语	汉语 Chinese
选择	选择 choice choose select
挑选	挑选 choice choose pick pick select
选举	选举 choose elect vote
教堂	教堂 church
教会	教会 church
纸烟	纸烟 cigarette
香烟	香烟 cigarette
电影	电影 cinema film movie
环绕	环绕 circle surround
圈子	圈子 circle
集团	集团 circle
公民	公民 citizen citizen
居民	居民 citizen
国籍	国籍 citizenship nationality
城市	城市 city
拍手	拍手 clap
鼓掌	鼓掌 clap
年级	年级 class grade
阶级	阶级 class
教室	教室 classroom schoolroom
粘土	粘土 clay
泥土	泥土 clay mud
清除	清除 clear
扫除	扫除 clear docleaning dosomecleaning sweep swept
清洁	清洁 clear
收拾	收拾 clearup
秘书	秘书 clerk secretary
职员	职员 clerk
攀登	攀登 climb
诊所	诊所 clinic
时钟	时钟 clock
关闭	关闭 close shut
壁橱	壁橱 closet
布料	布料 cloth
衣服	衣服 clothes clothing dress garment
社团	社团 club society
煤块	煤块 coal
海岸	海岸 coast
海滨	海滨 coast seaside
外套	外套 coat garment
上衣	上衣 coat jacket robe
公鸡	公鸡 cock
蚕茧	蚕茧 cocoon
代号	代号 code
电码	电码 code
咖啡	咖啡 coffee
硬币	硬币 coin
冷的	冷的 cold
寒冷	寒冷 cold
倒塌	倒塌 collapse falltopieces
崩溃	崩溃 collapse falltopieces
衣领	衣领 collar
收集	收集 collect getin
搜集	搜集 collect
聚集	聚集 collect gather gettogether
学院	学院 college institute
颜色	颜色 colour
梳子	梳子 comb
产生	产生 comeabout comeintobeing givebirthto produce
遇见	遇见 comeacross meet met
回来	回来 comeback getback return
复活	复活 comebacktolife
下来	下来 comedown getoff
喜剧	喜剧 comedy
来自	来自 comefrom from
进入	进入 comein enter entrance entry getin getinto into putinto
进来	进来 comein
形成	形成 comeintobeing
当权	当权 comeintopower
上台	上台 comeintopower
脱落	脱落 comeoff
赶快	赶快 comeon
来吧	来吧 comeon
出来	出来 comeout
共计	共计 cometo
走近	走近 comeup
长出	长出 comeup
发芽	发芽 comeup
抬头	抬头 comeup
上来	上来 comeup
上升	上升 comeup goup rise risen
安慰	安慰 comfort
舒适	舒适 comfort
评论	评论 comment remark
一般	一般 commonly
普通	普通 commonly
通常	通常 commonly usually
交往	交往 communicate company
交际	交际 communicate
同伴	同伴 companion fellow
同事	同事 companion workmate
陪伴	陪伴 company
公司	公司 company firm
商号	商号 company
比较	比较 compare
对照	对照 compare
比赛	比赛 compete competition game match race
竞赛	竞赛 compete competition match race
完成	完成 complete finish
彻底	彻底 complete
创作	创作 compose create
作曲	作曲 compose composition
作文	作文 composition
写作	写作 composition write
同志	同志 comrade
断定	断定 conclude judge
结论	结论 conclusion
推论	推论 conclusion
条件	条件 condition condition
状况	状况 condition state
环境	环境 condition environment surrounding
引导	引导 conduct lead
带领	带领 conduct showaround
指挥	指挥 conductor
导体	导体 conductor
讨论	讨论 conference discuss discussion
祝贺	祝贺 congratulate congratulation greeting
庆贺	庆贺 congratulation
推测	推测 conjecture
连接	连接 connect connectto join link
相通	相通 connect
相连	相连 connectto
涵义	涵义 connotation
征服	征服 conquer
克服	克服 conquer
得胜	得胜 conquer
考虑	考虑 consider think thinkabout thinkof thought
建造	建造 construction putup
查阅	查阅 consult
包含	包含 contain including
包括	包括 contain include including
容器	容器 container
内容	内容 content
大陆	大陆 continent mainland
继续	继续 continue goon goonwithone'swork keepon keepup succeed
连续	连续 continue
相反	相反 contrary
反面	反面 contrary
贡献	贡献 contribution
控制	控制 control
谈话	谈话 conversation haveatalk talk talkabout
交谈	交谈 conversation talk
烹调	烹调 cook
厨师	厨师 cook
食谱	食谱 cookbook
凉快	凉快 cool
合作	合作 cooperation
协作	协作 cooperation
珊瑚	珊瑚 coral
细绳	细绳 cord string
谷物	谷物 corn grain
玉米	玉米 corn
拐角	拐角 corner
角落	角落 corner
纠正	纠正 correct
改正	改正 correction
花费	花费 cost expense spend spendon
村舍	村舍 cottage
小屋	小屋 cottage hut shed
棉花	棉花 cotton
棉线	棉线 cotton
棉布	棉布 cotton
睡椅	睡椅 couch
咳嗽	咳嗽 cough
计数	计数 count
柜台	柜台 counter
国家	国家 country nation state
农村	农村 country countryside
乡下	乡下 country countryside
夫妇	夫妇 couple
勇气	勇气 courage
英勇	英勇 courage
胆量	胆量 courage
胆略	胆略 courage
过程	过程 course during process
道路	道路 course path road way
课程	课程 course
法庭	法庭 court
法院	法院 court
庭院	庭院 courtyard
院子	院子 courtyard yard
封面	封面 cover
遮盖	遮盖 cover
掩盖	掩盖 cover
母牛	母牛 cow
奶牛	奶牛 cow
工匠	工匠 craftsman
名匠	名匠 craftsman
爬行	爬行 crawl
疯狂	疯狂 crazy
乳脂	乳脂 cream
奶油	奶油 cream
创造	创造 create invent invention
造成	造成 create
脆的	脆的 crisp
批评	批评 criticize
鳄鱼	鳄鱼 crocodile
庄稼	庄稼 crop
收成	收成 crop
收获	收获 crop getin harvest
越过	越过 cross over
乌鸦	乌鸦 crow
人群	人群 crowd
拥挤	拥挤 crowd crowded
挤满	挤满 crowd
残忍	残忍 cruelty
残酷	残酷 cruelty
压碎	压碎 crush
杯子	杯子 cup
治疗	治疗 cure treat treatment
痊愈	痊愈 cure
居里	居里 Curie
卷毛	卷毛 curl
卷发	卷发 curl
卷曲	卷曲 curl
垫子	垫子 cushion mat
习惯	习惯 custom habit
风俗	风俗 custom
习俗	习俗 custom
顾客	顾客 customer
主顾	主顾 customer
砍掉	砍掉 cutaway
剪掉	剪掉 cutaway
切断	切断 cutoff shutoff
剪断	剪断 cutthrough
凿穿	凿穿 cutthrough
切碎	切碎 cutup
爸爸	爸爸 dad
爹爹	爹爹 dad
天天	天天 daily
日报	日报 daily
水坝	水坝 dam
水闸	水闸 dam
毁坏	毁坏 damage destroy ruin
损害	损害 damage doharmto harm injure
潮湿	潮湿 damp
跳舞	跳舞 dance
危险	危险 danger
敢于	敢于 dare
黑暗	黑暗 dark darkness
暗处	暗处 dark
黑色	黑色 dark
猛冲	猛冲 dash
短跑	短跑 dash
日期	日期 date
始于	始于 datefrom
女儿	女儿 daughter
儿媳	儿媳 daughterinlaw
戴维	戴维 David
黎明	黎明 dawn daylight
拂晓	拂晓 dawn
日光	日光 daylight sunshine
白天	白天 daylight daytime
白昼	白昼 daylight daytime
死的	死的 dead
聋的	聋的 deaf
分配	分配 deal divideup
处理	处理 deal dealwith getridof manage todealwith
应付	应付 dealwith
涉及	涉及 dealwith refer referto relate
债务	债务 debt
欠款	欠款 debt
决心	决心 decision determination determine will
甲板	甲板 deck
舱面	舱面 deck
声明	声明 declare manifesto statement
断言	断言 declare
事迹	事迹 deed
深切	深切 deep
击败	击败 defeat
失败	失败 defeat fail failure
挫折	挫折 defeat
防御	防御 defence
保卫	保卫 defence defend
防备	防备 defence
防守	防守 defend
定义	定义 definition
解说	解说 definition
度数	度数 degree
学位	学位 degree
程度	程度 degree
推迟	推迟 delay
耽搁	耽搁 delay
妙的	妙的 delicious
快乐	快乐 delight gay merry
递送	递送 deliver
交付	交付 deliver hand
发言	发言 deliver
德拉	德拉 Della
需要	需要 demand inneedof must need require requirement want
需求	需求 demand
兽穴	兽穴 den
意义	意义 denotation meaning sense
车间	车间 department workshop
依靠	依靠 depend dependon
依赖	依赖 dependon
信赖	信赖 dependon
深度	深度 depth
描写	描写 describe description portrait
描述	描述 describe
沙漠	沙漠 desert
荒地	荒地 desert
舍弃	舍弃 desert
遗弃	遗弃 desert
图案	图案 design
花样	花样 design
设计	设计 design
绘制	绘制 design draw
期望	期望 desire expect
课桌	课桌 desk
书桌	书桌 desk
绝望	绝望 despair
失望	失望 despair disappointment
破坏	破坏 destroy
侦探	侦探 detective
发展	发展 develop development evolution
开发	开发 develop development exploit
专心	专心 devote
献身	献身 devote
拨打	拨打 dial
对话	对话 dialog dialogue
对白	对白 dialog dialogue
钻石	钻石 diamond
日记	日记 diary
听写	听写 dictation
词典	词典 dictionary
辞典	辞典 dictionary
枯萎	枯萎 die
死于	死于 diefrom dieof
消灭	消灭 dieout
死绝	死绝 dieout
消失	消失 dieout disappear
灭亡	灭亡 dieout
饮食	饮食 diet
不同	不同 difference
难的	难的 difficult
困难	困难 difficulty trouble
费力	费力 difficulty
难事	难事 difficulty
散开	散开 diffuse
消化	消化 digest
领会	领会 digest grasp see understanding
文摘	文摘 digest
餐室	餐室 diningroom
食堂	食堂 diningroom
正餐	正餐 dinner
宴会	宴会 dinner
午饭	午饭 dinner lunch
晚饭	晚饭 dinner
浸入	浸入 dipinto
浏览	浏览 dipinto gothrough lookthrough
直接	直接 direct
指导	指导 direct direction guide
导演	导演 direct director
方向	方向 direction
方位	方位 direction
厂长	厂长 director
主任	主任 director
姓名	姓名 directory name
污物	污物 dirt
灰尘	灰尘 dirt dust
脏物	脏物 dirt
弄脏	弄脏 dirty pollute
残疾	残疾 disability
无能	无能 disability
弱点	弱点 disadvantage
消散	消散 disappear
沮丧	沮丧 disappointment
灾难	灾难 disaster
祸患	祸患 disaster
纪律	纪律 discipline
揭开	揭开 disclose
揭发	揭发 disclose
揭露	揭露 disclose expose
不安	不安 discomfort unrest
看出	看出 discover
暴露	暴露 discover
歧视	歧视 discrimination
议论	议论 discuss discussion remark
疾病	疾病 disease illness sickness trouble
磁盘	磁盘 dish
厌恶	厌恶 dislike horror
开除	开除 dismiss
距离	距离 distance
远处	远处 distance inthedistance
远的	远的 distant far
跳水	跳水 dive
潜水	潜水 dive
分开	分开 divide separate
分裂	分裂 divide split
划分	划分 divide
医生	医生 doctor
博士	博士 doctor
伤害	伤害 doharmto harm hurt injure injury
海豚	海豚 dolphin
尽力	尽力 doone'sbest
通道	通道 door opening passage
门铃	门铃 doorbell
门口	门口 doorway gateway
做饭	做饭 dosomecooking
小点	小点 dot
圆点	圆点 dot
点缀	点缀 dot
生效	生效 dothedeed
两倍	两倍 double twice
怀疑	怀疑 doubt
疑问	疑问 doubt
疑惑	疑惑 doubt
多佛	多佛 Dover
对付	对付 dowith manage todealwith
处置	处置 dowith
犯罪	犯罪 dowrong
十二	十二 dozen twelve
一打	一打 dozen
几十	几十 dozensof
绘画	绘画 draw drawing
引出	引出 draw
抽屉	抽屉 drawer
收网	收网 drawin
图画	图画 drawing picture
梦想	梦想 dream dreamof
做梦	做梦 dream
向往	向往 dreamof
渴望	渴望 dreamof long
服装	服装 dress
女装	女装 dress
穿着	穿着 dress haveon havesthon
化装	化装 dressup
操练	操练 drill
掉下	掉下 drill drop
喝酒	喝酒 drink
漏下	漏下 drip
滴下	滴下 drip drop
驱赶	驱赶 drive
驾驶	驾驶 drive
赶走	赶走 driveoff
司机	司机 driver
垂下	垂下 droop hang
落下	落下 drop fall
点滴	点滴 drop
溺死	溺死 drown
淹没	淹没 drown flood
药物	药物 drug
醉的	醉的 drunk
干燥	干燥 dry
变干	变干 dry
弄干	弄干 dry
干涸	干涸 dryup
公爵	公爵 duke
期间	期间 during period
尘土	尘土 dust
义务	义务 duty
职责	职责 duty office
责任	责任 duty
染色	染色 dye
炸药	炸药 dynamite
王朝	王朝 dynasty
朝代	朝代 dynasty
每人	每人 each everybody everyone everyone
每个	每个 each
每件	每件 each
互相	互相 eachother oneanother
彼此	彼此 eachother oneanother
耳朵	耳朵 ear
初期	初期 early
挣得	挣得 earn gain
赚得	赚得 earn
谋生	谋生 earnone'sliving living makealiving
地球	地球 earth globe
地震	地震 earthquake
安逸	安逸 ease
东方	东方 east
容易	容易 easy
吃完	吃完 eatup
吃光	吃光 eatup
响应	响应 echo
版本	版本 edition
编辑	编辑 editor
效果	效果 effect result
作用	作用 effect
努力	努力 effort try
例如	例如 eg forexample suchas
埃及	埃及 Egypt
十八	十八 eighteen
或者	或者 either eitheror or
要么	要么 either
长者	长者 elder
前辈	前辈 elder
推选	推选 elect
电的	电的 electric electrical
电流	电流 electricity
电学	电学 electricity
元素	元素 element
要素	要素 element
成分	成分 element
大象	大象 elephant
十一	十一 eleven
感情	感情 emotion feeling
情绪	情绪 emotion
激动	激动 emotion
皇帝	皇帝 emperor
强调	强调 emphasis
重点	重点 emphasis
帝国	帝国 empire
雇用	雇用 employ hire
倒空	倒空 empty
空的	空的 empty hollow
鼓励	鼓励 encourage encouragement
末尾	末尾 end
终点	终点 end
告终	告终 endup
敌人	敌人 enemy
敌军	敌军 enemy
精力	精力 energy
活力	活力 energy
能量	能量 energy
从事	从事 engage takeup upto
约定	约定 engage
引擎	引擎 engine
机车	机车 engine
技师	技师 engineer
英语	英语 English
享乐	享乐 enjoyment
扩大	扩大 enlarge
加入	加入 enter join joinin
入口	入口 entrance gateway
入场	入场 entrance
信封	信封 envelope
纸袋	纸袋 envelope
封皮	封皮 envelope
嫉妒	嫉妒 envy
平等	平等 equality
赤道	赤道 equator
装备	装备 equip equipment furnish
配备	配备 equip
设备	设备 equipment fitting service set
逃跑	逃跑 escape runaway
逃脱	逃脱 escape runaway
特别	特别 especially particularly
尤其	尤其 especially particularly
散文	散文 essay
欧洲	欧洲 Europe
甚至	甚至 even
即使	即使 even evenif though
纵然	纵然 evenif though
傍晚	傍晚 evening
晚会	晚会 evening
大事	大事 event
每一	每一 every per
人人	人人 everybody everyone everyone
事事	事事 everything
邪恶	邪恶 evil
罪恶	罪恶 evil
演变	演变 evolution
进化	进化 evolution
考试	考试 examination examination test
测试	测试 examination
诊察	诊察 examine
例子	例子 examine
实例	实例 examine
榜样	榜样 examine
藉口	藉口 excuse
托辞	托辞 excuse
原谅	原谅 excuse forgive pardon
宽恕	宽恕 excuse forgive mercy pardon
借口	借口 excuse
辩解	辩解 excuse
锻炼	锻炼 exercise sport
做操	做操 exercise
练习	练习 exercise practice practise
习题	习题 exercise problem
存在	存在 exist existence lie occur
生存	生存 exist existence live survival
出口	出口 exit
预期	预期 expect
料想	料想 expect suppose
盼望	盼望 expect lookforwardto
消费	消费 expense
支出	支出 expense
经验	经验 experience
体验	体验 experience
经历	经历 experience
实验	实验 experiment
试验	试验 experiment haveatest puttothetest test trial tryout
专家	专家 expert
能手	能手 expert
解释	解释 explain explanation
说明	说明 explain explanation instruction setout
开采	开采 exploit
表示	表示 express expression
表达	表达 express expression
词句	词句 expression
表情	表情 expression
说法	说法 expression
延伸	延伸 extend
伸展	伸展 extend spread
极其	极其 extremely
眼睛	眼睛 eye
眉毛	眉毛 eyebrow
视力	视力 eyesight sight
面孔	面孔 face
面对	面对 face
面向	面向 face
正视	正视 face
当面	当面 facetoface
事实	事实 fact
实际	实际 fact
工厂	工厂 factory work
退去	退去 fade
相当	相当 fairly rather
还算	还算 fairly
公平	公平 fairness
公正	公正 fairness judgement justice
仙女	仙女 fairy
童话	童话 fairytales
下降	下降 fall falloff
倒下	倒下 fall fallover
跌倒	跌倒 fall fallover
睡着	睡着 fallasleep gotosleep
入睡	入睡 fallasleep gotosleep
患病	患病 fallill
爱上	爱上 fallinlovewith
跌落	跌落 falloff
家庭	家庭 family
家族	家族 family race
子女	子女 family
扇子	扇子 fan
风扇	风扇 fan
球迷	球迷 fan
远地	远地 far
遥远	遥远 faraway
很远	很远 faraway
农场	农场 farm
农庄	农庄 farm
农夫	农夫 farmer
农舍	农舍 farmhouse
农事	农事 farming
耕作	耕作 farming
农田	农田 farmland
较远	较远 farther
更远	更远 farther
迷惑	迷惑 fascination
快的	快的 fast quick rapid swift
扎牢	扎牢 fasten
扣住	扣住 fasten
肥胖	肥胖 fat
脂肪	脂肪 fat
油脂	油脂 fat
命运	命运 fate
父亲	父亲 father parent
缺点	缺点 fault shortcoming
错误	错误 fault mistake
过去	过去 fault goby inthepast past
毛病	毛病 fault thematter
恩惠	恩惠 favour favor
好意	好意 favour favor
传真	传真 fax
恐惧	恐惧 fear
羽毛	羽毛 feather
二月	二月 February
喂养	喂养 feed
饲养	饲养 feed raise
感觉	感觉 feel feeling sense
感知	感知 feel
触角	触角 feeler
家伙	家伙 fellow
伙伴	伙伴 fellow
篱笆	篱笆 fence
肥料	肥料 fertilizer
去拿	去拿 fetch
发烧	发烧 fever
发热	发热 fever
不多	不多 few
田地	田地 field
田场	田场 field
牧场	牧场 field grassland
场地	场地 field
领域	领域 field
田鼠	田鼠 fieldmouse
十五	十五 fifteen
第五	第五 fifth
五十	五十 fifty
打仗	打仗 fight
打架	打架 fight
斗争	斗争 fight struggle
还击	还击 fightback
战士	战士 fighter soldier
数字	数字 figure number
塑像	塑像 figure
画像	画像 figure portrait
充满	充满 fill fullof
装满	装满 fill
填充	填充 fill fillin
填空	填空 fillin
影片	影片 film picture
胶卷	胶卷 film
最终	最终 finally
末了	末了 finally
找到	找到 find found
发觉	发觉 find found sense
感到	感到 find found
查找	查找 find found
找出	找出 findout
查出	查出 findout
了解	了解 findout knew know known see
很好	很好 fine
细的	细的 fine
细雨	细雨 finerain
手指	手指 finger
开火	开火 fire
射击	射击 fire fire shoot shooting shot
解雇	解雇 fire fire
火炉	火炉 fire stove
火灾	火灾 fire
开头	开头 fire
火警	火警 firealarm
木柴	木柴 firewood wood
柴火	柴火 firewood
企业	企业 firm
第一	第一 first
首次	首次 first
最初	最初 first
急救	急救 firstaid
鱼肉	鱼肉 fish
捕鱼	捕鱼 fish
钓鱼	钓鱼 fish gofishing shopping
渔夫	渔夫 fisherman
渔网	渔网 fishingnet
拳头	拳头 fist
合身	合身 fit
符合	符合 fit
适应	适应 fitinwith
装置	装置 fitting service set
修理	修理 fix mend repair
安装	安装 fix
确定	确定 fix makesureof
安顿	安顿 fixup
注视	注视 fixupon regard watch
凝视	凝视 fixupon stare stareat
电讯	电讯 flash
闪光	闪光 flash
闪亮	闪亮 flash
平的	平的 flat
阿谀	阿谀 flatter
奉承	奉承 flatter
肉体	肉体 flesh
航班	航班 flight
飞行	飞行 flight fly
漂浮	漂浮 float
浮动	浮动 float
地板	地板 floor
楼层	楼层 floor
面粉	面粉 flour
流动	流动 flow
空运	空运 fly
折迭	折迭 fold
合拢	合拢 fold
人们	人们 folk people
家属	家属 folk
跟随	跟随 follow
接着	接着 follow
遵循	遵循 follow
听从	听从 follow obey
信徒	信徒 follower
食物	食物 food
食品	食品 food grocery
愚弄	愚弄 fool
欺骗	欺骗 fool
蠢人	蠢人 fool
傻子	傻子 fool idiot
愚蠢	愚蠢 foolish
英尺	英尺 foot
足球	足球 football
脚印	脚印 footmark footprint
足迹	足迹 footmark footprint track
暂时	暂时 forawhile
一刻	一刻 forawhile
不许	不许 forbid
强迫	强迫 force oblige
迫使	迫使 force oblige
前额	前额 forehead
前腿	前腿 foreleg
预见	预见 foresee
预知	预知 foresee
森林	森林 forest wood
免费	免费 forfree freeofcharge
忘记	忘记 forget
忘掉	忘掉 forget
餐叉	餐叉 fork
岔口	岔口 fork
形状	形状 form shape
形式	形式 form
组织	组织 form organise organization organize
第四	第四 forth fourth
幸亏	幸亏 fortunately thanksto
财产	财产 fortune possession wealth
运气	运气 fortune luck
四十	四十 forty
将来	将来 forward future infuture inthefuture
今后	今后 forward fromnowon inthefuture
成立	成立 found
地基	地基 foundation
喷泉	喷泉 fountain
十四	十四 fourteen
狐狸	狐狸 fox
法郎	法郎 franc
法国	法国 France
自由	自由 freedom
结冰	结冰 freeze froze frozen
凝固	凝固 freeze
冰点	冰点 freezing
极冷	极冷 freezing
冻结	冻结 freezing
法语	法语 French
淡的	淡的 fresh
冰箱	冰箱 fridge
朋友	朋友 friend
友谊	友谊 friendship
友好	友好 friendship
惊恐	惊恐 frighten
吓唬	吓唬 frighten
从起	从起 from
有时	有时 fromtimetotime nowandthen onceinawhile sometimes
不时	不时 fromtimetotime nowandthen
间或	间或 fromtimetotime onceinawhile
时常	时常 fromtimetotime
从到	从到 fromto
前面	前面 front
前线	前线 front
水果	水果 fruit
果实	果实 fruit
油煎	油煎 fry
油炒	油炒 fry
油炸	油炸 fry
煎锅	煎锅 fryingpan
燃料	燃料 fuel
满的	满的 full
玩笑	玩笑 fun joke
滑稽	滑稽 funny
古怪	古怪 funny
毛皮	毛皮 fur
皮子	皮子 fur
布置	布置 furnish
家具	家具 furniture
进修	进修 furthereducation
深造	深造 furthereducation
未来	未来 future
赢得	赢得 gain win
获得	获得 gain get obtain
游戏	游戏 game
空隙	空隙 gap
缺口	缺口 gap
差距	差距 gap
花园	花园 garden
果园	果园 garden
菜园	菜园 garden
园艺	园艺 gardening
煤气	煤气 gas
气体	气体 gas
喘息	喘息 gasp
喘气	喘气 gasp pant
屏息	屏息 gaspat holdone'sbreath
大门	大门 gate
关口	关口 gateway
采集	采集 gather
愉快	愉快 gay happiness merry pleasure
将军	将军 general
大意	大意 generalidea
一代	一代 generation
妖怪	妖怪 genie spirit
天才	天才 genius
绅士	绅士 gentleman
先生	先生 gentleman mister monsieur Mr sir
地理	地理 geography
细菌	细菌 germ
德语	德语 German
德国	德国 Germany
姿势	姿势 gesture
手势	手势 gesture
具有	具有 get with
得到	得到 get obtain receive
收到	收到 get receive
进展	进展 getalong getalongwith progress
返回	返回 getback
取回	取回 getback
接近	接近 getcloseto
降下	降下 getdown lower
下车	下车 getdown getoff
收割	收割 getin harvest
插话	插话 getinaword
结婚	结婚 getmarried marriage marry wedding
脱下	脱下 getoff takeoff
上车	上车 geton
出去	出去 getout
除掉	除掉 getridof
去掉	去掉 getridof getridof remove rid
通过	通过 getthrough go gothrough pass through
打通	打通 getthrough
联欢	联欢 gettogether
认识	认识 gettoknow knew know known recognize
起床	起床 getup rise risen
巨人	巨人 giant
赠品	赠品 gift
礼物	礼物 gift present
礼品	礼品 gift
天资	天资 gift
女孩	女孩 girl
递给	递给 give
给予	给予 give
付出	付出 give
归还	归还 giveback return
送回	送回 giveback return
让步	让步 givein
发出	发出 giveoff letout sendout
发光	发光 giveoff glow shine
用完	用完 giveout runoutof
耗尽	耗尽 giveout
分发	分发 giveout handout
放弃	放弃 giveup
冰河	冰河 glacier
冰川	冰川 glacier
一瞥	一瞥 glance
瞪眼	瞪眼 glare
玻璃	玻璃 glass
眼镜	眼镜 glass spectacles
温室	温室 glasshouse
暖房	暖房 glasshouse
手套	手套 glove
灼热	灼热 glow
胶水	胶水 glue
用吧	用吧 goahead
干吧	干吧 goahead
山羊	山羊 goat
走开	走开 goaway gooff
回去	回去 goback
变坏	变坏 gobad
坏掉	坏掉 gobad
上帝	上帝 god
下去	下去 godown
天哪	天哪 Godsaveme Goodheavens
回家	回家 gohome home
挨饿	挨饿 gohungry starve
黄金	黄金 gold
金色	金色 gold
金子	金子 gold
金鱼	金鱼 goldfish
良好	良好 good
再见	再见 goodbye
你好	你好 Goodmorning hello
商品	商品 goods
货物	货物 goods load
熄灭	熄灭 goout
复习	复习 goover goover review revision
滑冰	滑冰 goskating skate skating swimming
查看	查看 gothrough watchover
翻阅	翻阅 gothrough
睡觉	睡觉 gotobed sleep slept
上学	上学 gotoschool
上涨	上涨 goup
上楼	上楼 goupstairs
统治	统治 govern rule
管理	管理 govern manage
政府	政府 government state
总督	总督 governor
变白	变白 gowhite
急抓	急抓 grab
体面	体面 grace
文雅	文雅 grace
等级	等级 grade
学年	学年 grade
毕业	毕业 graduation
谷类	谷类 grain
谷粒	谷粒 grain
语法	语法 grammar
孙女	孙女 granddaughter
祖父	祖父 grandfather
奶奶	奶奶 grandma
外婆	外婆 grandma
祖母	祖母 grandmother granny
爷爷	爷爷 grandpa
外公	外公 grandpa
孙子	孙子 grandson
外孙	外孙 grandson
假定	假定 grant suppose suppose
葡萄	葡萄 grape
掌握	掌握 grasp handle master
草地	草地 grass grassland meadow
牧草	牧草 grass
草原	草原 grassland
重力	重力 gravity
灰色	灰色 gray
伟大	伟大 greatness
巨大	巨大 greatness
希腊	希腊 Greece
贪心	贪心 greed
贪婪	贪婪 greed
青的	青的 green
绿色	绿色 green
问候	问候 greet greeting regards
致敬	致敬 greet greeting salute
杂货	杂货 grocery
土地	土地 ground land soil
小组	小组 group
团体	团体 group
生长	生长 grow grow
发育	发育 grow
种植	种植 grow plant
成年	成年 growup
成长	成长 growup
长大	长大 growup
哨兵	哨兵 guard
警戒	警戒 guard lookout
客人	客人 guest
指南	指南 guide
向导	向导 guide
眉题	眉题 guideword
吉他	吉他 guitar
鸿沟	鸿沟 gulf
火药	火药 gunpowder
体操	体操 gym gymnastics
习性	习性 habit
最好	最好 hadbetter
头发	头发 hair
理发	理发 haircut
一半	一半 half
会堂	会堂 hall
大厅	大厅 hall
礼堂	礼堂 hall
火腿	火腿 ham
铁锤	铁锤 hammer
锤打	锤打 hammer
指针	指针 hand
传递	传递 hand pass
交给	交给 hand
一把	一把 handful
少数	少数 handful minority
交上	交上 handin
递交	递交 handin
交纳	交纳 handin
并进	并进 handinhand
联合	联合 handinhand join union unite
手帕	手帕 handkerchief
手绢	手绢 handkerchief
散发	散发 handout
握手	握手 handshake shakehands
倒立	倒立 handstand
书法	书法 handwriting
笔迹	笔迹 handwriting
吊着	吊着 hang
悬挂	悬挂 hang
绞死	绞死 hanged
吊死	吊死 hanged
碰巧	碰巧 happen
幸福	幸福 happiness happy
硬的	硬的 hard solid
硬座	硬座 hardseat
野兔	野兔 hare
哈柏	哈柏 Harper
孵出	孵出 hatch
孵卵	孵卵 hatch
斧头	斧头 hatchet
憎恨	憎恨 hate
不愿	不愿 hate
举行	举行 haveamatch held hold
开会	开会 haveameeting
休息	休息 havearest relaxation rest take
考查	考查 haveatest test
散步	散步 haveawalk walk
上课	上课 haveclasses havelessons
必须	必须 havegotto haveto must
戴着	戴着 haveon havesthon
有事	有事 haveon
干草	干草 hay
头部	头部 head
头痛	头痛 headache
出发	出发 headfor setoff setout start
标题	标题 headline title
校长	校长 headmaster schoolmaster
健康	健康 health
卫生	卫生 health
听见	听见 hear
听说	听说 hear hearabout hearof learn
得知	得知 hear
听力	听力 hearing
心脏	心脏 heart
天国	天国 heaven
天堂	天堂 heaven
天空	天空 heaven sky
重的	重的 heavy
黑体	黑体 heavytype
铅字	铅字 heavytype type
高度	高度 height
握住	握住 held hold takeholdof
帮忙	帮忙 help
自取	自取 helponeselfto
母鸡	母鸡 hen
亨利	亨利 Henry
她的	她的 her hers
这儿	这儿 here
这里	这里 here
处处	处处 hereandthere
给你	给你 Hereyouare
英雄	英雄 hero
勇士	勇士 hero
踌躇	踌躇 hesitate
犹豫	犹豫 hesitate
冬眠	冬眠 hibernate hibernation
隐藏	隐藏 hid hidden hide
高的	高的 high tall
高楼	高楼 highriseblock
大厦	大厦 highriseblock
公路	公路 highway road
大路	大路 highway
小山	小山 hill
希尔	希尔 Hill
山腰	山腰 hillside
山坡	山坡 hillside
租用	租用 hire
他的	他的 his
历史	历史 history
击中	击中 hit
想出	想出 hiton thinkof
蜂房	蜂房 hive
怀有	怀有 hold
持有	持有 hold
抑制	抑制 hold
阻止	阻止 holdback prevent stop
昂首	昂首 holdone'sheadhigh
坚持	坚持 holdout insist insiston perseverance stickto
支持	支持 holdout support
伸出	伸出 holdout stick
举起	举起 holdup lift putup raise
停顿	停顿 holdup pause
假日	假日 holiday
假期	假期 holiday vacation
节日	节日 holiday
到家	到家 home
祖国	祖国 homeland motherland
故乡	故乡 hometown
家乡	家乡 hometown
蜂蜜	蜂蜜 honey
蜂窝	蜂窝 honeycomb
甘汁	甘汁 honeydew
蜜露	蜜露 honeydew
荣誉	荣誉 honor
尊敬	尊敬 honor respect
敬意	敬意 honor
跳过	跳过 hop skip
希望	希望 hope wish
喇叭	喇叭 horn
恐怖	恐怖 horror
马背	马背 horseback
赛马	赛马 horserace race
医院	医院 hospital
主人	主人 host master
热的	热的 hot
热狗	热狗 hotdog
旅馆	旅馆 hotel
饭店	饭店 hotel
温泉	温泉 hotspring
小时	小时 hour kph
房子	房子 house
住房	住房 housing
怎样	怎样 how
如何	如何 how
多少	多少 how howmany howmuch
多么	多么 how what
不过	不过 however just nomorethan
多远	多远 howfar
嚎叫	嚎叫 howl
嚎哭	嚎哭 howl
多久	多久 howlong
几岁	几岁 howold
紧抱	紧抱 hug
抱住	抱住 hug
人的	人的 human
人性	人性 humannature
人权	人权 humanright
幽默	幽默 humour
驼峰	驼峰 hump
饥饿	饥饿 hunger starvation
追猎	追猎 hunt
猎取	猎取 hunt
追赶	追赶 hunt
打猎	打猎 hunt hunting
猎人	猎人 hunter
亨特	亨特 Hunter
飓风	飓风 hurricane
赶紧	赶紧 hurry hurryup
匆忙	匆忙 hurry inahurry
快点	快点 hurry hurryup
受伤	受伤 hurt
丈夫	丈夫 husband
棚屋	棚屋 hut
茅屋	茅屋 hut
冰山	冰山 iceberg
主意	主意 idea
意见	意见 idea mind opinion
打算	打算 idea intend setout
想法	想法 idea mind mind thinking thought
念头	念头 idea
思想	思想 idea mind
成语	成语 idiom
白痴	白痴 idiot
如果	如果 if
假使	假使 if
是否	是否 if whether
生病	生病 ill
虐待	虐待 illtreat
想象	想象 imagination imagine
设想	设想 imagine
立即	立即 immediately
重要	重要 importance
重大	重大 importance
显要	显要 importance
印象	印象 impress
改善	改善 improve
提高	提高 improve raise
改进	改进 improve
更新	更新 improve
在家	在家 in
在内	在内 in
向内	向内 in into
穿戴	穿戴 in
英寸	英寸 inch
渐进	渐进 inch
掌管	掌管 inchargeof takecharge
负责	负责 inchargeof takecharge
插曲	插曲 incident
事变	事变 incident
所得	所得 income
收入	收入 income
共同	共同 incommon
共用	共用 incommon
增长	增长 increase rise
繁殖	繁殖 increase
负债	负债 indebt
欠帐	欠帐 indebt
确实	确实 indeed really surely
实在	实在 indeed
的确	的确 indeed
独立	独立 independence
印度	印度 India
工业	工业 industry
产业	产业 industry
告诉	告诉 inform tell told
情报	情报 information
信息	信息 information message
墨水	墨水 ink
现代	现代 inmoderntimes
近代	近代 inmoderntimes
客栈	客栈 inn
整齐	整齐 inorder order
以便	以便 inorderthat inorderto soasto sothat
为了	为了 inorderthat inorderto
称赞	称赞 inpraiseof
歌颂	歌颂 inpraiseof
当众	当众 inpublic
追求	追求 insearchof
昆虫	昆虫 insect
插入	插入 insert
内部	内部 inside
里面	里面 inside
主张	主张 insist
视察	视察 inspect inspection
检阅	检阅 inspection
警官	警官 inspector
鼓舞	鼓舞 inspiration inspire
激励	激励 inspire urge
不管	不管 inspiteof nomatter
不顾	不顾 inspiteof
瞬间	瞬间 instant minute moment
即时	即时 instant
代替	代替 instead insteadof standfor taketheplaceof
顶替	顶替 instead
学会	学会 institute learn
协会	协会 institute
学校	学校 institution school
指示	指示 instruct
须知	须知 instruction
乐器	乐器 instrument musicalinstrument
器具	器具 instrument tool
想要	想要 intend want wish
兴趣	兴趣 interest
趣味	趣味 interest
采访	采访 interview
领先	领先 inthelead lead
从前	从前 inthepast once onceuponatime
及时	及时 intime
到内	到内 into
到里	到里 into
变成	变成 into turinto turninto
介绍	介绍 introduce introduction
引进	引进 introduction
依次	依次 inturn takeone'sturn
发明	发明 invent invention
请帖	请帖 invitation
邀请	邀请 invitation invite
招待	招待 invite serve
熨斗	熨斗 iron
灌溉	灌溉 irrigate irrigation water
岛民	岛民 islander
小岛	小岛 isle
它的	它的 its
杰克	杰克 Jack
果酱	果酱 jam
一月	一月 January
正月	正月 January
日本	日本 Japan
坛子	坛子 jar
罐子	罐子 jar
下巴	下巴 jaw
妒忌	妒忌 jealous
詹妮	詹妮 Jenny
喷射	喷射 jet
宝石	宝石 jewel
珠宝	珠宝 jewellery jewelry
吉姆	吉姆 Jim
工作	工作 job task work
约翰	约翰 John
参军	参军 jointhearmy
笑话	笑话 joke
记者	记者 journalist reporter
旅行	旅行 journey tour travel trip
旅程	旅程 journey trip
路程	路程 journey path
欢乐	欢乐 joy merry
乐趣	乐趣 joy
判断	判断 judge
判决	判决 judge judgement sentence
裁判	裁判 judge judgement
法官	法官 judge
审判	审判 judgement trial try
大壶	大壶 jug
七月	七月 July
跳离	跳离 jumpoff
六月	六月 June
丛林	丛林 jungle
密林	密林 jungle
旧货	旧货 junk secondhand
正好	正好 just right
恰好	恰好 just
正义	正义 justice
公道	公道 justice
凯特	凯特 Kate
凯茜	凯茜 Kathy
保存	保存 keep save
保持	保持 keep keepup remain
留住	留住 keep
保留	保留 keepback
留下	留下 keepback
让开	让开 keepoff
反复	反复 keepon overandover
维持	维持 keepup support
跟上	跟上 keepupwith
守望	守望 keepwatch lookout onwatch
值班	值班 keepwatch onwatch
放哨	放哨 keepwatch
肯特	肯特 Kent
煤油	煤油 kerosene
钥匙	钥匙 key
键盘	键盘 keyboard
踢脱	踢脱 kickoff
诱拐	诱拐 kidnap
绑架	绑架 kidnap
杀死	杀死 kill
弄死	弄死 kill
公斤	公斤 kilo
千克	千克 kilo
公里	公里 kilo kilometre kilometer
千米	千米 kilo kilometre kilometer kph squarekilometres
种类	种类 kind nature sort species variety
国王	国王 king
王国	王国 kingdom
接吻	接吻 kiss
厨房	厨房 kitchen
灶间	灶间 kitchen
风筝	风筝 kite
膝盖	膝盖 knee
腿部	腿部 knee
跪着	跪着 kneel
跪下	跪下 kneel
懂得	懂得 knew know known understand
知道	知道 knew know known
小刀	小刀 knife
相撞	相撞 knock
碰撞	碰撞 knock
敲门	敲门 knockat
敲窗	敲窗 knockat
知识	知识 knowledge
学问	学问 knowledge
考拉	考拉 koala
劳动	劳动 labor labour work
缺少	缺少 lack shortage
少年	少年 lad
梯子	梯子 ladder
女士	女士 lady madam Madame miss Ms
夫人	夫人 lady madam Madame Mrs
小姐	小姐 lady miss
下蛋	下蛋 laid lay
产卵	产卵 laid lay
平放	平放 lain lay lie
羔羊	羔羊 lamb
跛的	跛的 lame
瘸的	瘸的 lame
油灯	油灯 lamp
陆地	陆地 land
登陆	登陆 land
地主	地主 landowner
语言	语言 language tongue
提灯	提灯 lantern
灯笼	灯笼 lantern
舔食	舔食 lap suck
持续	持续 last
耐久	耐久 last
去年	去年 lastyear
晚点	晚点 late
最近	最近 lately
大笑	大笑 laugh
嘲笑	嘲笑 laugh laughat
笑声	笑声 laughter
法律	法律 law
法令	法令 law
法典	法典 lawbook
律师	律师 lawyer
领导	领导 lead
首位	首位 lead
领袖	领袖 leader
导致	导致 leadto
导向	导向 leadto
叶子	叶子 leaf
联盟	联盟 league union
团员	团员 Leaguemember
漏洞	漏洞 leak
漏隙	漏隙 leak
倾斜	倾斜 lean slant
记住	记住 learbyheart memorize
背诵	背诵 learbyheart recite
学习	学习 learn study
获悉	获悉 learn
最小	最小 least
最少	最少 least
剩下	剩下 leave remain
离去	离去 leave moveaway
讲课	讲课 lecture
演讲	演讲 lecture speech talk
左边	左边 left
向左	向左 left
长度	长度 length
列宁	列宁 Lenin
功课	功课 lesson
教训	教训 lesson
不到	不到 lessthan notuntil
少于	少于 lessthan
放出	放出 letout sendout
泄露	泄露 letout
字母	字母 letter
莴苣	莴苣 lettuce
水平	水平 level
标准	标准 level standard
解放	解放 liberate liberation
舔吃	舔吃 lick
平躺	平躺 lie
位于	位于 lie
说谎	说谎 lie telllies
谎话	谎话 lie
躺下	躺下 liedown
生命	生命 life
一生	一生 life lifetime
生活	生活 life live living
终身	终身 lifetime
抬起	抬起 lift putup
电梯	电梯 lift
轻的	轻的 light
点燃	点燃 light
照亮	照亮 light
点着	点着 light
闪电	闪电 lightning
喜爱	喜爱 like
限度	限度 limit
限制	限制 limit limit
蹒跚	蹒跚 limp
林肯	林肯 Lincoln
林达	林达 Linda
排队	排队 line
台词	台词 line
联系	联系 link relation
狮子	狮子 lion
嘴唇	嘴唇 lip
目录	目录 list
名单	名单 list
倾听	倾听 listen
公升	公升 litre liter
小的	小的 little small
少的	少的 little small
居住	居住 live
活的	活的 live living
实况	实况 live
现场	现场 live
装载	装载 load
锁住	锁住 lock
锁上	锁上 lock
蝗虫	蝗虫 locust
木头	木头 log wood
伦敦	伦敦 London
长久	长久 long
观看	观看 look lookat watch
照看	照看 lookafter
回顾	回顾 lookbackupon
期待	期待 lookforwardto
调查	调查 lookinto research
仰望	仰望 lookup
松的	松的 loose
贵族	贵族 lord noble nobleman
卡车	卡车 lorry truck
失去	失去 lose
丢失	丢失 lose lost
丧失	丧失 lose loss
灰心	灰心 loseheart
气馁	气馁 loseheart
牺牲	牺牲 loseone'slife
失音	失音 loseone'svoice
减肥	减肥 loseweight
损耗	损耗 loss
迷失	迷失 lost
迷途	迷途 lost
热爱	热爱 love
放下	放下 lower
好运	好运 luck
隆起	隆起 lump
肿块	肿块 lump
午餐	午餐 lunch
肺脏	肺脏 lung
机器	机器 machine machinery
机构	机构 machinery
太太	太太 madam Madame
制造	制造 made make produce
使得	使得 made make
杂志	杂志 magazine
女仆	女仆 maid
少女	少女 maid
处女	处女 maid
侍女	侍女 maid
邮政	邮政 mail post
邮件	邮件 mail
邮递	邮递 mail
邮筒	邮筒 mailbox
邮箱	邮箱 mailbox
邮车	邮车 mailcoach
崇高	崇高 majesty
尊严	尊严 majesty
君主	君主 majesty
制作	制作 make production shape
度日	度日 makealiving
吵闹	吵闹 makeanoise
允诺	允诺 makeapromise promise will
往返	往返 makearoundtrip
取笑	取笑 makefunof
成功	成功 makeone'smark succeed succeedin success
出名	出名 makeone'smark
立论	立论 makeone'spoint
务必	务必 makesure
务请	务请 makesure
确保	确保 makesureof
组成	组成 makeup
编出	编出 makeup
弥补	弥补 makeupfor
利用	利用 makeuseof use
男人	男人 man
人类	人类 man mankind
设法	设法 manage
经营	经营 manage manage
办理	办理 manage
经理	经理 manager
宣言	宣言 manifesto
方式	方式 manner
举止	举止 manner
礼貌	礼貌 manners
三月	三月 march
进军	进军 march
栏外	栏外 margin
标明	标明 mark
痕迹	痕迹 mark trail
污点	污点 mark
记号	记号 mark sign
商标	商标 mark
分数	分数 mark
市场	市场 market marketplace
售市	售市 market
侯爵	侯爵 marquis
婚姻	婚姻 marriage
马丁	马丁 Martin
玛丽	玛丽 Mary
众多	众多 mass
精通	精通 master
杰作	杰作 masterpiece
名著	名著 masterpiece
火柴	火柴 match
相配	相配 match
成对	成对 match
大副	大副 mate
原料	原料 material
材料	材料 material
数学	数学 mathematics maths
问题	问题 matter problem question subject trouble
物质	物质 matter substance
要紧	要紧 matter
或许	或许 may maybe
也许	也许 may might perhaps possibly
五月	五月 may
大概	大概 maybe probably would
市长	市长 mayor
镇长	镇长 mayor
饭食	饭食 meal
意思	意思 meaning
方法	方法 means method technique way
手段	手段 means way
量度	量度 measure
奖章	奖章 medal medal
勋章	勋章 medal
医学	医学 medicine
碰见	碰见 meet met
迎接	迎接 meet
集会	集会 meet meeting met
成员	成员 member
会员	会员 member
记忆	记忆 memory
回忆	回忆 memory
修补	修补 mend repair
提到	提到 mention refer referto
说起	说起 mention
菜单	菜单 menu
菜谱	菜谱 menu
商人	商人 merchant
怜悯	怜悯 mercy pity
仁慈	仁慈 mercy
仅仅	仅仅 merely nomorethan only simply
消息	消息 message news
金属	金属 metal
办法	办法 method
公尺	公尺 metre meter
微机	微机 microcomputer
正午	正午 midday noon
中间	中间 middle
当中	当中 middle
午夜	午夜 midnight
迈克	迈克 Mike
英里	英里 mile
牛奶	牛奶 milk
挤奶	挤奶 milk
出奶	出奶 milk
百万	百万 million
心情	心情 mind
介意	介意 mind
我的	我的 mine my
矿山	矿山 mine
矿井	矿井 mine
矿物	矿物 mineral
矿石	矿石 mineral
大臣	大臣 minister
部长	部长 minister
牧师	牧师 minister
负的	负的 minus
分钟	分钟 minute
一会	一会 minute
镜子	镜子 mirror
惦念	惦念 miss
怀念	怀念 miss
错过	错过 miss
想念	想念 miss
惦记	惦记 miss
误会	误会 misunderstanding
误解	误解 misunderstanding
混合	混合 mix
搅和	搅和 mix
模型	模型 model
原型	原型 model
式样	式样 model pattern
片刻	片刻 moment
时刻	时刻 moment
金钱	金钱 money
货币	货币 money
班长	班长 monitor
和尚	和尚 monk
猴子	猴子 monkey
月亮	月亮 moon
更多	更多 more
更大	更大 more
早晨	早晨 morning
早上	早上 morning
上午	上午 morning
最多	最多 most
母亲	母亲 mother parent
马达	马达 motor
箴语	箴语 motto
格言	格言 motto
山脉	山脉 mountain
哀痛	哀痛 mourn
哀悼	哀悼 mourn
老鼠	老鼠 mouse
耗子	耗子 mouse
鼠标	鼠标 mouse
一口	一口 mouthful
移动	移动 move
搬家	搬家 move
迁入	迁入 movein
更加	更加 much
胜过	胜过 muchbetterthan
泥浆	泥浆 mud
桑树	桑树 mulberry
桑葚	桑葚 mulberry
妈妈	妈妈 mum
干尸	干尸 mummy
谋杀	谋杀 murder
凶手	凶手 murderer
嘟哝	嘟哝 murmur
肌肉	肌肉 muscle
音乐	音乐 music
乐曲	乐曲 music
乐师	乐师 musician
应当	应当 must ought oughtto
钉子	钉子 nail
名字	名字 name
名称	名称 name
民族	民族 nation nationality
自然	自然 nature ofcourse
性质	性质 nature
海军	海军 navy
近的	近的 near
邻近	邻近 near
将近	将近 nearly
脖子	脖子 neck
项链	项链 necklace
项圈	项圈 necklace
必要	必要 need want
必需	必需 need
缝针	缝针 needle
黑人	黑人 Negro
邻居	邻居 neighbor neighbour
邻人	邻人 neighbor neighbour
都不	都不 neither
也不	也不 neither neithernor nor
既不	既不 neithernor
侄子	侄子 nephew
外甥	外甥 nephew
决不	决不 never
新的	新的 new
新闻	新闻 news
报纸	报纸 newspaper paper
牛顿	牛顿 Newton
纽约	纽约 NewYork
然后	然后 next then
贴近	贴近 nextto
好的	好的 nice
侄女	侄女 niece
甥女	甥女 niece
夜间	夜间 night
黑夜	黑夜 night
夜晚	夜晚 night
十九	十九 nineteen
九十	九十 ninety
第九	第九 ninth
不是	不是 no
没有	没有 no without
点头	点头 nod
响声	响声 noise
不再	不再 nolonger nomore notanylonger notanymore
胡说	胡说 nonsense
北部	北部 north
北方	北方 north
挪威	挪威 Norway
鼻子	鼻子 nose
不像	不像 notasas
不如	不如 notasas
便条	便条 note
短笺	短笺 note
钞票	钞票 note
笔记	笔记 note
注释	注释 note
布告	布告 notice
名词	名词 noun
当今	当今 nowadays
时而	时而 nowandagain nowandthen
无处	无处 nowhere
难怪	难怪 nowonderthat
既然	既然 nowthat since
号码	号码 number
数量	数量 number quantity
护士	护士 nurse
护理	护理 nursing tend
坚果	坚果 nut
绿洲	绿洲 oasis
服从	服从 obey
顺从	顺从 obey
物体	物体 object
对象	对象 object
观察	观察 observation observe
观测	观测 observation
偶尔	偶尔 occasionally onceinawhile
占有	占有 occupy possess takepossessionof
海洋	海洋 ocean sea
洋底	洋底 oceanfloor
点钟	点钟 o'clock
十月	十月 October
停了	停了 off
提出	提出 offer refer
职务	职务 office
军官	军官 officer
官员	官员 official
常常	常常 often
经常	经常 often
旧的	旧的 old
在上	在上 on over up
穿上	穿上 on
戴上	戴上 on puton
放上	放上 on
接通	接通 on switch
一度	一度 once
一只	一只 one
相继	相继 oneafteranother
顺次	顺次 oneafteranother
自身	自身 oneself
自己	自己 oneself self
走路	走路 onfoot
步行	步行 onfoot walk
洋葱	洋葱 onion
只是	只是 only
展出	展出 onshow
播送	播送 ontheair
按时	按时 ontime
准时	准时 ontime
打开	打开 open unfold unwrap
张开	张开 open
开放	开放 opening
开创	开创 openup
开辟	开辟 openup
操作	操作 operate operation
运转	运转 operate work
手术	手术 operation
见解	见解 opinion thinking view
良机	良机 opportunity
反抗	反抗 oppose rebellion
压迫	压迫 oppress
压抑	压抑 oppress
否则	否则 or orelse otherwise
橙子	橙子 orange
桔子	桔子 orange
柑子	柑子 orange
橙色	橙色 orange
命令	命令 order summon
定货	定货 order
意向	意向 order
顺序	顺序 order turn
规则	规则 order rule
秩序	秩序 order
孤儿	孤儿 orphan
上下	上下 orso
别人	别人 other
哎哟	哎哟 ouch
应该	应该 ought oughtto should
向外	向外 out outof outward
在外	在外 out outof
爆发	爆发 outburst
太空	太空 outerspace space
失业	失业 outofwork
外部	外部 outside
外面	外面 outside
完了	完了 over
再三	再三 overandover
大衣	大衣 overcoat
欠债	欠债 owe
所有	所有 own possession
拥有	拥有 own possess possession takepossessionof
物主	物主 owner
公牛	公牛 ox ploxen
牛津	牛津 Oxford
氧气	氧气 oxygen
步速	步速 pace
打包	打包 pack
包裹	包裹 package parcel wrap
包装	包装 package
页码	页码 page
付钱	付钱 paid pay payforsth
痛的	痛的 painful
粉刷	粉刷 paint
油漆	油漆 paint
涂料	涂料 paint
画家	画家 painter
油画	油画 painting
宫殿	宫殿 palace
平锅	平锅 pan
盘子	盘子 pan plate
考卷	考卷 paper
票据	票据 paper
借约	借约 paper
借据	借据 paper
巴黎	巴黎 Paris
公园	公园 park
鹦鹉	鹦鹉 parrot
部分	部分 part section
零件	零件 part
部件	部件 part
搭档	搭档 partner
词类	词类 partofspeech
聚会	聚会 party
政党	政党 party
党派	党派 party
党员	党员 Partymember
路过	路过 pass
走廊	走廊 passage
一段	一段 passage
忽略	忽略 passby
乘客	乘客 passenger
旅客	旅客 passenger traveller
过客	过客 passerby
护照	护照 passport
昔日	昔日 past
轻拍	轻拍 pat tap
抚摩	抚摩 pat
补钉	补钉 patch
小道	小道 path
忍耐	忍耐 patience
耐心	耐心 patience
容忍	容忍 patience putupwith
格调	格调 pattern
保罗	保罗 Paul
中止	中止 pause
暂停	暂停 pause
亭子	亭子 pavilion
脚爪	脚爪 paw
偿还	偿还 payback repaid repay
支付	支付 payforsth
还清	还清 payoff
和平	和平 peace
桃子	桃子 peach
农民	农民 peasant
钢笔	钢笔 pen
铅笔	铅笔 pencil
便士	便士 penny plpence
履行	履行 perform
时期	时期 period stage time
时代	时代 period
许可	许可 permission permit
容许	容许 permit
毅力	毅力 perseverance
劝说	劝说 persuade
说服	说服 persuade
害虫	害虫 pest
宠物	宠物 pet
爱畜	爱畜 pet
彼得	彼得 Peter
现象	现象 phenomenon
相片	相片 photo
照片	照片 photo photograph picture
短语	短语 phrase
体育	体育 physicaleducation
钢琴	钢琴 piano
扒窃	扒窃 pick
选出	选出 pickout
拣出	拣出 pickout
拾起	拾起 pickup raise
接收	接收 pickup
野餐	野餐 picnic picnicked
图片	图片 picture
馅饼	馅饼 pie
鸽子	鸽子 pigeon
堆积	堆积 pile pileup
堆起	堆起 pile
药丸	药丸 pill
枕头	枕头 pillow
钉住	钉住 pin
松树	松树 pine
先锋	先锋 pioneer
管子	管子 pipe tube
导管	导管 pipe
烟斗	烟斗 pipe
比萨	比萨 Pisa
遗憾	遗憾 pity regret sorrow
同情	同情 pity
可怜	可怜 pity
地方	地方 place room
位置	位置 place position situation
定购	定购 placeanorder
平原	平原 plain
旷野	旷野 plain
计划	计划 plan program programme
平面	平面 plane
行星	行星 planet
厚板	厚板 plank
播种	播种 plant sow
塑料	塑料 plastics
碟子	碟子 plate
讲台	讲台 platform
站台	站台 platform station
打球	打球 play
玩耍	玩耍 play
戏剧	戏剧 play
捉弄	捉弄 playatrickon
选手	选手 player
操场	操场 playground schoolyard
充足	充足 plenty
警察	警察 plpolicemen police policeman
绵羊	绵羊 plsheep sheep
肺炎	肺炎 pneumonia
衣袋	衣袋 pocket
韵文	韵文 poem
诗人	诗人 poet
观点	观点 point
论点	论点 point
要点	要点 point
尖端	尖端 point tip
指向	指向 point pointto
指出	指出 point pointout
说及	说及 pointout
毒药	毒药 poison
毒物	毒物 poison
毒害	毒害 poison
中毒	中毒 poison
政治	政治 politics
污染	污染 pollute pollution
池塘	池塘 pond
鱼塘	鱼塘 pond
小池	小池 pool
水塘	水塘 pool
水池	水池 pool tank
水坑	水坑 pool
歌星	歌星 popstar
人口	人口 population
人数	人数 population
猪肉	猪肉 pork
港市	港市 port
口岸	口岸 port
肖像	肖像 portrait
阵地	阵地 position
邮寄	邮寄 post
职位	职位 post
邮局	邮局 post postoffice
邮费	邮费 postage
海报	海报 poster
招贴	招贴 poster
邮戳	邮戳 postmark
土豆	土豆 potato
英镑	英镑 pound
流出	流出 pour
倾泻	倾泻 pour
粉末	粉末 powder
政权	政权 power
权力	权力 power
势力	势力 power
力量	力量 power strength
电力	电力 power
实践	实践 practice practise
实习	实习 practice
赞扬	赞扬 praise
表扬	表扬 praise
童车	童车 pram
祈祷	祈祷 pray
祈求	祈求 pray
祈褥	祈褥 prayer
宁可	宁可 prefer rather
宁愿	宁愿 prefer rather
准备	准备 preparation prepare
预备	预备 prepare
总统	总统 president
压按	压按 press
压力	压力 pressure
假装	假装 pretend
装作	装作 pretend
防止	防止 prevent preventfrom
预防	预防 prevent preventfrom
妨碍	妨碍 preventfrom
价格	价格 price
代价	代价 price
骄傲	骄傲 pride
自满	自满 pride
公主	公主 princess
印刷	印刷 print printing
打印	打印 print
监狱	监狱 prison
囚犯	囚犯 prisoner
犯人	犯人 prisoner
奖品	奖品 prize
奖金	奖金 prize
奖赏	奖赏 prize reward
难题	难题 problem
工序	工序 process
行进	行进 procession
队伍	队伍 procession
行列	行列 procession
生产	生产 produce production
教授	教授 professor
节目	节目 program programme
规划	规划 program programme
项目	项目 program programme
程序	程序 programme
进步	进步 progress
工程	工程 project
诺言	诺言 promise
预示	预示 promise
发音	发音 pronounce pronunciation
证据	证据 proof
证明	证明 proof prove
论证	论证 proof
证实	证实 prove
酒店	酒店 pub
出版	出版 publish
发行	发行 publish putout
喷出	喷出 puff
吹气	吹气 puff
果肉	果肉 pulp
脉搏	脉搏 pulse
惩罚	惩罚 punish punishment
处罚	处罚 punish
学生	学生 pupil student
意图	意图 purpose
钱包	钱包 purse
推动	推动 pushon
推倒	推倒 pushover
刮倒	刮倒 pushover
放好	放好 putaway
扑灭	扑灭 putdown putout
平息	平息 putdown
记下	记下 putdown writedown
输入	输入 putinto
上演	上演 puton
发福	发福 putonweight
关熄	关熄 putout
检验	检验 puttothetest
张帖	张帖 putup
搭起	搭起 putup setup
挂起	挂起 putup
忍受	忍受 putupwith
震动	震动 quake shake shock
颤抖	颤抖 quake
品质	品质 quality
争吵	争吵 quarrel
吵架	吵架 quarrel
女王	女王 queen
王后	王后 queen
迅速	迅速 quickly
被子	被子 quilt
十分	十分 quilt
测验	测验 quiz test
兔子	兔子 rabbit
赛跑	赛跑 race
人种	人种 race
种族	种族 race
辐射	辐射 radiation
射线	射线 radiation ray
放射	放射 radiation
抹布	抹布 rag
破布	破布 rag
大怒	大怒 rage
铁轨	铁轨 rail
轨道	轨道 rail track
铁路	铁路 rail railway
栏杆	栏杆 rail
雨水	雨水 rain
下雨	下雨 rain
雨衣	雨衣 raincoat
抚养	抚养 raise
军衔	军衔 rank
光线	光线 ray
抵达	抵达 reach
看懂	看懂 read
辩认	辩认 read
觉察	觉察 read
阅读	阅读 read
朗读	朗读 read reading
读者	读者 reader
读本	读本 reader
读物	读物 reading
真的	真的 real
现实	现实 reality
理由	理由 reason
造反	造反 rebel rebellion
反叛	反叛 rebel
叛乱	叛乱 rebellion
重建	重建 rebuild rebuilt
改造	改造 rebuild
接到	接到 receive
受到	受到 receive
遭到	遭到 receive
近来	近来 recently
接待	接待 reception
认出	认出 recognize
记录	记录 record
记载	记载 record
唱片	唱片 record
恢复	恢复 recover
回收	回收 recycle
红色	红色 red
减少	减少 reduce
缩减	缩减 reduce
抽出	抽出 reel
提交	提交 refer
有关	有关 refer referto relate
参考	参考 reference
附注	附注 reference
谈到	谈到 referto talkabout talkof
参照	参照 referto
反射	反射 reflection
拒绝	拒绝 refuse
看待	看待 regard treat
当作	当作 regard
致意	致意 regards
抱歉	抱歉 regret
缰绳	缰绳 rein
抛弃	抛弃 reject
拒收	拒收 reject
关系	关系 relation relationship
亲属	亲属 relation relative
亲戚	亲戚 relative
松驰	松驰 relax relaxation
放松	放松 relax relaxation
替班	替班 relay
宽慰	宽慰 relief
欣慰	欣慰 relief
宗教	宗教 religion
仍是	仍是 remain
残余	残余 remains
陈述	陈述 remark setout statement
再娶	再娶 remarry
再嫁	再嫁 remarry
记得	记得 remember
想起	想起 remember remind thinkof
提醒	提醒 remind
记起	记起 remind
取去	取去 remove
拿走	拿走 remove take takeaway
脱掉	脱掉 remove
消除	消除 remove
移开	移开 remove
续借	续借 renew
还钱	还钱 repaid repay
报答	报答 repay reward
重复	重复 repeat
重说	重说 repeat
重做	重做 repeat
取代	取代 replace
报告	报告 report
汇报	汇报 report
重读	重读 reread
再读	再读 reread
营救	营救 rescue
援救	援救 rescue
研究	研究 research study
抵抗	抵抗 resist
抵制	抵制 resist
资源	资源 resource
尊重	尊重 respect
支撑	支撑 rest support
饭馆	饭馆 restaurant
归来	归来 return
复审	复审 review
温习	温习 revision
革命	革命 revolution
变革	变革 revolution
报酬	报酬 reward
重写	重写 rewrite rewritten rewrote
改写	改写 rewrite
大米	大米 rice
米饭	米饭 rice
骑马	骑马 ride
恰恰	恰恰 right
对的	对的 right
铃声	铃声 ring
铃响	铃响 ring
摇铃	摇铃 ring
戒指	戒指 ring rung
熟的	熟的 ripe
升高	升高 rise
起立	起立 rise risen up
起义	起义 riseup
河边	河边 riverside
街道	街道 road street traffic
掠夺	掠夺 rob seize
抢劫	抢劫 rob
长袍	长袍 robe
岩石	岩石 rock
摇动	摇动 rock shake
火箭	火箭 rocket
岩面	岩面 rockface
摇椅	摇椅 rockingchair
打滚	打滚 roll
滚动	滚动 roll
滚筒	滚筒 roller
翻滚	翻滚 rollover
罗马	罗马 Rome
屋顶	屋顶 roof
顶部	顶部 roof top
地位	地位 room
房间	房间 room
空间	空间 room space
余地	余地 room
根茎	根茎 root
绳子	绳子 rope
罗斯	罗斯 rose
腐烂	腐烂 rot rotaway
腐败	腐败 rot
烂掉	烂掉 rotaway
围绕	围绕 round surround
圆的	圆的 round
围着	围着 round
赶拢	赶拢 roundup
路线	路线 route way
一排	一排 row
一行	一行 row
划船	划船 rowboat
罗伊	罗伊 Roy
摩擦	摩擦 rub
橡皮	橡皮 rubber
橡胶	橡胶 rubber
垃圾	垃圾 rubbish waste
废物	废物 rubbish
毁灭	毁灭 ruin
规定	规定 rule
奔跑	奔跑 run
运行	运行 run
逃走	逃走 runaway
冲出	冲出 rushout
俄国	俄国 Russia
俄语	俄语 Russian
悲伤	悲伤 sadness
悲惨	悲惨 sadness
悲哀	悲哀 sadness
忧伤	忧伤 sadness
安全	安全 safety
保险	保险 safety
航行	航行 sail sailing voyage
航海	航海 sailing voyage
海员	海员 sailor seaman
水手	水手 sailor seaman
水兵	水兵 sailor
色拉	色拉 salad
薪水	薪水 salary
销售	销售 sale
出售	出售 sale
店员	店员 salesman shopassistant
盐的	盐的 salty
咸的	咸的 salty
敬礼	敬礼 salute
萨米	萨米 Sammy
沙地	沙地 sand
沙子	沙子 sand
桑迪	桑迪 Sandy
下沉	下沉 sank sink sunk
消沉	消沉 sank sink sunk
树液	树液 sap
卫星	卫星 satellite
满足	满足 satisfaction satisfy
满意	满意 satisfaction satisfy
酱汁	酱汁 sauce
节省	节省 save save spare
挽救	挽救 save
储蓄	储蓄 save
贮存	贮存 save
理解	理解 saw see seen understand understanding
看望	看望 saw see seen
俗话	俗话 saying
谚语	谚语 saying
甲虫	甲虫 scarab
分散	分散 scatter
一场	一场 scene
场景	场景 scene
布景	布景 scene
风景	风景 scenery sight view
景色	景色 scenery view
校舍	校舍 schoolhouse
教师	教师 schoolmaster teacher
同学	同学 schoolmate
校园	校园 schoolyard
科学	科学 science
斥责	斥责 scold
责骂	责骂 scold
二十	二十 score twenty
得分	得分 score
获胜	获胜 score win
乱涂	乱涂 scratch
尖叫	尖叫 scream
屏幕	屏幕 screen
海鸥	海鸥 seagull
海豹	海豹 seal
船员	船员 seaman
搜查	搜查 search
探索	探索 search
搜寻	搜寻 search
海贝	海贝 seashell
贝壳	贝壳 seashell
季节	季节 season
座位	座位 seat
海水	海水 seawater
海草	海草 seaweed
海藻	海藻 seaweed
第二	第二 second
秘密	秘密 secret
书记	书记 secretary
看见	看见 see
种子	种子 seed
玩弄	玩弄 seek
探寻	探寻 seek
占领	占领 seize
很少	很少 seldom
不常	不常 seldom
自我	自我 self
售完	售完 sellout
卖完	卖完 sellout
半圆	半圆 semicircle
派遣	派遣 send sendout sent
发射	发射 send sendup shot
打发	打发 send sent
寄出	寄出 send sent
感官	感官 sense
意识	意识 sense
句子	句子 sentence
宣判	宣判 sentence
隔离	隔离 separate separation
分离	分离 separation
九月	九月 September
农奴	农奴 serf
警士	警士 sergeant
军士	军士 sergeant
仆人	仆人 servant
佣人	佣人 servant
服务	服务 serve service
服役	服役 serve
开饭	开饭 serve
上菜	上菜 serve
点火	点火 setfireto
放火	放火 setfireto
释放	释放 setfree
动身	动身 setoff
着手	着手 setout start
启航	启航 setsail
解决	解决 settle solve workout
停留	停留 settle stay
安家	安家 settle
定居	定居 settledown
成家	成家 settledown
部落	部落 settlement
村落	村落 settlement
创立	创立 setup
竖立	竖立 setup
七十	七十 seventy
几个	几个 several some
数个	数个 several
缝纫	缝纫 sew
缝制	缝制 sew
缝补	缝补 sew
缝上	缝上 sew sewed sown
缝做	缝做 sew sewed sown
性别	性别 sex
树阴	树阴 shade
窗帘	窗帘 shade
树荫	树荫 shade
阴影	阴影 shadow
影子	影子 shadow
颤动	颤动 shake
将要	将要 shall should
浅的	浅的 shallow
羞愧	羞愧 shame
分享	分享 share
分担	分担 share
尖的	尖的 sharp
剃刮	剃刮 shave
薄片	薄片 sheet
薄板	薄板 sheet
架子	架子 shelf
母狼	母狼 shewolf
照耀	照耀 shine
衬衫	衬衫 shirt
冲击	冲击 shock
震惊	震惊 shock
射中	射中 shoot
射死	射死 shoot
抛出	抛出 shoot
嫩枝	嫩枝 shoot
打枪	打枪 shoot
投篮	投篮 shootabasket
商店	商店 shop store
店铺	店铺 shop
购物	购物 shopping
短的	短的 short
矮的	矮的 short
不足	不足 shortage
短处	短处 shortcoming
缩短	缩短 shorten
短波	短波 shortwave
射手	射手 shot
肩膀	肩膀 shoulder
铁锨	铁锨 shovel
给看	给看 show
出示	出示 show
显示	显示 show
参观	参观 showaround visit
阵雨	阵雨 shower
淋浴	淋浴 shower
炫耀	炫耀 showoff
关住	关住 shut
关门	关门 shut
禁闭	禁闭 shut
闭嘴	闭嘴 shutup
住口	住口 shutup
侧面	侧面 side
岔路	岔路 sideway
旁路	旁路 sideway
叹气	叹气 sigh
视觉	视觉 sight
情景	情景 sight
迹象	迹象 sign
符号	符号 sign
标记	标记 sign
签名	签名 sign signature
信号	信号 signal
暗号	暗号 signal
寂静	寂静 silence still
安静	安静 silence
沉默	沉默 silence
蚕丝	蚕丝 silk
傻的	傻的 silly
演唱	演唱 sing
唱歌	唱歌 sing
阁下	阁下 sir
姐妹	姐妹 sister
形势	形势 situation
情况	情况 situation
十六	十六 sixteen
六十	六十 sixty
尺寸	尺寸 size
大小	大小 size
滑雪	滑雪 ski
技能	技能 skill
技巧	技巧 skill
熟练	熟练 skill
皮肤	皮肤 skin
女裙	女裙 skirt
掌击	掌击 slap
拍打	拍打 slap
奴隶	奴隶 slave
睡眠	睡眠 sleep
睡袋	睡袋 sleepingbag
滑动	滑动 slide slip
溜走	溜走 slip
拖鞋	拖鞋 slipper
便鞋	便鞋 slipper
慢的	慢的 slow
迟钝	迟钝 slow
闻到	闻到 smell smelt
气味	气味 smell
微笑	微笑 smile
吸烟	吸烟 smoke
攫取	攫取 snatch
抽泣	抽泣 sniffle
下雪	下雪 snow
雪堆	雪堆 snowdrift
大雪	大雪 snowstorm
这么	这么 so
那么	那么 so such then well
如此	如此 so
同样	同样 so
所以	所以 so therefore
浸湿	浸湿 soak
淋湿	淋湿 soak
肥皂	肥皂 soap
呜咽	呜咽 sob
啜泣	啜泣 sob
社会	社会 society
短袜	短袜 sock
软的	软的 soft
土壤	土壤 soil
士兵	士兵 soldier soldier
固体	固体 solid
解答	解答 solve
某些	某些 some
有人	有人 somebody someone
某人	某人 somebody someone
某事	某事 something
某物	某物 something
某处	某处 somewhere
儿子	儿子 son
歌曲	歌曲 song
歌唱	歌唱 song
迟早	迟早 soonerorlater
煤烟	煤烟 soot
悲痛	悲痛 sorrow
类别	类别 sort
以致	以致 sothat
精华	精华 soul
灵魂	灵魂 soul
心灵	心灵 soul
气魄	气魄 soul
声音	声音 sound
来源	来源 source
根源	根源 source
南方	南方 south
南部	南部 south
空地	空地 space
间隙	间隙 space
间隔	间隔 space
余暇	余暇 sparetime
麻雀	麻雀 sparrow
说话	说话 speak talk
讲话	讲话 speak speech talk
梭镖	梭镖 spear
言语	言语 speech
速度	速度 speed
加速	加速 speed
拼写	拼写 spell spelt
拼字	拼字 spelling
度过	度过 spend
花钱	花钱 spendon
蜘蛛	蜘蛛 spider
精神	精神 spirit
吐痰	吐痰 spit
吐出	吐出 spitout throwup
劈开	劈开 split
撕开	撕开 split
切开	切开 split
调羹	调羹 spoon
孢子	孢子 spore
场所	场所 spot
班点	班点 spot
传开	传开 spread
伸开	伸开 spread
伸长	伸长 spread
展开	展开 spread unfold
传播	传播 spread
流传	流传 spread
春天	春天 spring
春季	春季 spring
源泉	源泉 spring
侦察	侦察 spy
密探	密探 spy
间谍	间谍 spy
窥探	窥探 spyon
平方	平方 square
广场	广场 square
鱿鱼	鱿鱼 squid
松鼠	松鼠 squirrel
雄鹿	雄鹿 stag
舞台	舞台 stage
阶段	阶段 stage
楼梯	楼梯 stair
邮票	邮票 stamp
看台	看台 stand
站起	站起 stand stood
立正	立正 standatattention
代表	代表 standfor
象征	象征 standfor
主演	主演 star
起点	起点 startingpoint
饿死	饿死 starvation starve
状态	状态 state
车站	车站 station
驻扎	驻扎 station
安置	安置 station
电台	电台 station
暂住	暂住 stay
逗留	逗留 stay
挺住	挺住 stayup
站立	站立 stayup
窃取	窃取 steal
偷窃	偷窃 steal
蒸汽	蒸汽 steam
树干	树干 stem trunk
叶梗	叶梗 stem
脚步	脚步 step
继母	继母 stepmother
陷入	陷入 stick
粘住	粘住 stickto
仍旧	仍旧 still
开动	开动 stmoving
腹部	腹部 stomach
肚子	肚子 stomach
胃痛	胃痛 stomachache
石头	石头 stone
停止	停止 stop
跑表	跑表 stopwatch
贮藏	贮藏 storage supply
储存	储存 storage
存贮	存贮 store
储藏	储藏 store
存储	存储 store
风暴	风暴 storm
故事	故事 story tale
小说	小说 story
一层	一层 story
直的	直的 straight
外行	外行 stranger
溪流	溪流 stream
力气	力气 strength
加强	加强 strengthen
变强	变强 strengthen
增强	增强 strengthen
侵袭	侵袭 strike
打火	打火 strike
罢工	罢工 strike
带子	带子 string tie
闲逛	闲逛 stroll
奋斗	奋斗 struggle
笨的	笨的 stupid
主题	主题 subject topic
题目	题目 subject title topic
科目	科目 subject
主语	主语 subject
郊区	郊区 suburb
事物	事物 such
吮吸	吮吸 suck
舐食	舐食 suck
受苦	受苦 suffer
遭受	遭受 suffer sufferfrom
痛苦	痛苦 suffering
苦难	苦难 suffering
暗示	暗示 suggest
提议	提议 suggest
衣箱	衣箱 suitcase
总额	总额 sum total
摘要	摘要 summary
概要	概要 summary
夏天	夏天 summer
夏季	夏季 summer
传唤	传唤 summon
太阳	太阳 sun
阳光	阳光 sun sunshine
日出	日出 sunrise
晚餐	晚餐 supper
供给	供给 supply
供应	供应 supply
补充	补充 supply
赡养	赡养 support
猜想	猜想 suppose
肯定	肯定 sure
确信	确信 sure
表面	表面 surface
水面	水面 surface
惊奇	惊奇 surprise wonder
诧异	诧异 surprise wonder
意外	意外 surprise
包围	包围 surround
幸存	幸存 survival
吞下	吞下 swallow
咽下	咽下 swallow
摇摆	摇摆 sway swing
瑞典	瑞典 Sweden
甜的	甜的 sweet
糖果	糖果 sweet
白薯	白薯 sweetpotato
山芋	山芋 sweetpotato
挥舞	挥舞 swing swung
摆动	摆动 swing swung
转换	转换 switch
瑞士	瑞士 Switzerland
刀剌	刀剌 swordthrust
剑剌	剑剌 swordthrust
制度	制度 system
体系	体系 system
系统	系统 system
桌子	桌子 table
尾巴	尾巴 tail
尾部	尾部 tail
裁缝	裁缝 tailor
带走	带走 take
就座	就座 take takeaseat takeone'splace
坐船	坐船 takeaboat
打的	打的 takeataxi
保管	保管 takecareof
拿下	拿下 takedown
取下	取下 takedown
拥抱	拥抱 takeinone'sarm
拿掉	拿掉 takeoff
呈现	呈现 takeon
就位	就位 takeone'splace
轮流	轮流 takeone'sturn
参与	参与 takepartin
照像	照像 takephotos
拍照	拍照 takephotos
接替	接替 taketheplaceof
占去	占去 takeup
占据	占据 takeup
传说	传说 tale
谈论	谈论 talkabout
说到	说到 talkof
商谈	商谈 talkover
商量	商量 talkover
家禽	家禽 tamebirds
油船	油船 tanker
轻打	轻打 tap
卷尺	卷尺 tape
磁带	磁带 tape
打出	打出 tapout
任务	任务 task
尝味	尝味 taste
滋味	滋味 taste
味道	味道 taste
教书	教书 taught teach
税款	税款 tax
抽税	抽税 tax
征税	征税 tax
茶叶	茶叶 tea
教员	教员 teacher
教学	教学 teaching
教导	教导 teaching
学说	学说 teaching
队友	队友 teammate
眼泪	眼泪 tear
泪珠	泪珠 tear
扯开	扯开 tear tore torn
撕裂	撕裂 tear tore torn
拆毁	拆毁 teardown
拆除	拆除 teardown
茶室	茶室 tearoom
拔出	拔出 tearup
技术	技术 technique technology
电报	电报 telegram telegraph
电视	电视 television
讲述	讲述 tell told
吩咐	吩咐 tell told
脾气	脾气 temper
温度	温度 temperature
庙宇	庙宇 temple
寺院	寺院 temple
引诱	引诱 temptation
诱惑	诱惑 temptation
佃户	佃户 tenant
房客	房客 tenant
嫩的	嫩的 tender
网球	网球 tennis
帐篷	帐篷 tent
学期	学期 term
用语	用语 term
字眼	字眼 term
恐吓	恐吓 terrify
试管	试管 testtube
课文	课文 text
文本	文本 text
课本	课本 text textbook
感谢	感谢 thank
谢谢	谢谢 thank
那个	那个 that the
这个	这个 the this
这些	这些 the these
那些	那些 the those
剧场	剧场 theater
戏院	戏院 theater
后天	后天 thedayaftertomorrow
前天	前天 thedaybeforeyesterday
长城	长城 theGreatWall
他们	他们 their theirs them themselves they
她们	她们 their theirs them themselves they
它们	它们 them they
明朝	明朝 theMingDynasty
越越	越越 themorethe
愈愈	愈愈 themorethe
当时	当时 then
那时	那时 then
理论	理论 theory
原理	原理 theory
人民	人民 thepeople
首相	首相 thePrimeMinister
丞相	丞相 thePrimeMinister
总理	总理 thePrimeMinister
公众	公众 thepublic
民众	民众 thepublic
那儿	那儿 there
如今	如今 thesedays
触觉	触觉 thesenseoftouch
联邦	联邦 theUnion
厚的	厚的 thick
浓的	浓的 thick
粗的	粗的 thick
小偷	小偷 thief
瘦的	瘦的 thin
薄的	薄的 thin
东西	东西 thing
物品	物品 thing
用品	用品 thing
思考	思考 think thought
思索	思索 thinking
第三	第三 third
口渴	口渴 thirst
渴的	渴的 thirsty
十三	十三 thirteen
三十	三十 thirty
纱线	纱线 thread
喉咙	喉咙 throat
贯穿	贯穿 throughout
摔倒	摔倒 throw
扔掉	扔掉 throwaway throwoff
摆脱	摆脱 throwoff
呕吐	呕吐 throwup
猛刺	猛刺 thrustatsomebody
这样	这样 thus
因而	因而 thus
潮水	潮水 tide
整洁	整洁 tidy
领结	领结 tie
老虎	老虎 tiger
紧的	紧的 tight
紧地	紧地 tightly
直到	直到 till until
木料	木料 timber
木材	木材 timber wood
次数	次数 time
时间	时间 time
钟点	钟点 time
多次	多次 timeandtimeagain
一罐	一罐 tin
木端	木端 tip
轮胎	轮胎 tire tyre
车胎	车胎 tire tyre
累的	累的 tired
书名	书名 title
头衔	头衔 title
烟草	烟草 tobacco
烟叶	烟叶 tobacco
托德	托德 Tod
今天	今天 today
当前	当前 today
应讨	应讨 todealwith
一起	一起 together
厕所	厕所 toilet
东京	东京 Tokyo
汤姆	汤姆 Tom
蕃茄	蕃茄 tomato
坟墓	坟墓 tomb
明天	明天 tomorrow
舌头	舌头 tongue tongue
方言	方言 tongue
口语	口语 tongue
今晚	今晚 tonight
过分	过分 too
工具	工具 tool
用具	用具 tool
牙齿	牙齿 tooth
逃学	逃学 toplaytruant
乌龟	乌龟 tortoise
龟甲	龟甲 tortoiseshell
总的	总的 total
合计	合计 total
中肯	中肯 tothepoint
扼要	扼要 tothepoint
接触	接触 touch
触摸	触摸 touch
够着	够着 touch
观光	观光 tour tourism
对于	对于 toward
市镇	市镇 town
城镇	城镇 town
玩具	玩具 toy
玩物	玩物 toy
跑道	跑道 track
贸易	贸易 trade trade
行业	行业 trade
经商	经商 trade trade
交易	交易 trade
工会	工会 tradeunion
交通	交通 traffic
车辆	车辆 traffic
小径	小径 trail
训练	训练 train training
拖裙	拖裙 train
教练	教练 trainer
培训	培训 training
恍惚	恍惚 trance
出神	出神 trance
发呆	发呆 trance
翻译	翻译 translate translation
译文	译文 translation
运输	运输 transport
财富	财富 treasure wealth
对待	对待 treat treatment
疗法	疗法 treatment
发抖	发抖 tremble
摇晃	摇晃 tremble
试用	试用 trial
诡计	诡计 trick
计谋	计谋 trick
淌滴	淌滴 trickle
细流	细流 trickle
部队	部队 troop
烦恼	烦恼 trouble worry
长裤	长裤 trousers
象鼻	象鼻 trunk
真理	真理 truth
真实	真实 truth
真相	真相 truth
审问	审问 try
试穿	试穿 tryon
坑道	坑道 tunnel
地道	地道 tunnel
隧道	隧道 tunnel
草皮	草皮 turf
旋转	旋转 turn whirl
转动	转动 turn work
翻转	翻转 turn
转变	转变 turn
背叛	背叛 turnagainst
关小	关小 turndown
调低	调低 turndown
特纳	特纳 Turner
交出	交出 turnin
关掉	关掉 turnoff
旋开	旋开 turnon
翻到	翻到 turnover turnto
翻身	翻身 turnover
转向	转向 turnto
长牙	长牙 tusk
两次	两次 twice
孪生	孪生 twins
盘旋	盘旋 twist
缠绕	缠绕 twist wind
类型	类型 type
样式	样式 type
打字	打字 type
雨伞	雨伞 umbrella
姨父	姨父 uncle
姑夫	姑夫 uncle
姨夫	姨夫 uncle
明白	明白 understand
领悟	领悟 understanding
谅解	谅解 understanding
制服	制服 uniform
团结	团结 union unite
单位	单位 unit
单元	单元 unit
统一	统一 unite
宇宙	宇宙 universe
大学	大学 university
除非	除非 unless
开门	开门 unload
箱等	箱等 unload
骚动	骚动 unrest
无私	无私 unselfishness
慷慨	慷慨 unselfishness
解开	解开 unwrap
起来	起来 up
向上	向上 up upward
上边	上边 upside
上部	上部 upside
倒转	倒转 upsidedown
颠倒	颠倒 upsidedown
催促	催促 urge
我们	我们 us we
使用	使用 use use
应用	应用 use
用途	用途 use
往常	往常 usually
休假	休假 vacation
流域	流域 valley valley
山谷	山谷 valley
价值	价值 value
益处	益处 value
蒸气	蒸气 vapour
种种	种种 variety
花瓶	花瓶 vase
蔬菜	蔬菜 vegetable
金星	金星 Venus
动词	动词 verb
胜利	胜利 victory
录像	录像 video
视域	视域 view
村庄	村庄 village
乡村	乡村 village
村民	村民 villager
德行	德行 virtue
词汇	词汇 vocabulary
嗓音	嗓音 voice
嗓子	嗓子 voice
排球	排球 volleyball
投票	投票 vote
腰部	腰部 waist
背心	背心 waistcoat
马甲	马甲 waistcoat
等候	等候 wait waitfor
侍者	侍者 waiter
等待	等待 waitfor
醒来	醒来 wake wakeup woke woken
弄醒	弄醒 wakeup
叫醒	叫醒 wakeup
钱夹	钱夹 wallet
皮夹	皮夹 wallet
徘徊	徘徊 wander
流浪	流浪 wander
漫游	漫游 wander
战争	战争 war
警告	警告 warn warning
告诫	告诫 warn
警报	警报 warning warningmessage
军舰	军舰 warship
战舰	战舰 warship
战时	战时 wartime
冲走	冲走 washaway
冲垮	冲垮 washaway
浪费	浪费 waste
废料	废料 waste
看守	看守 watch
守卫	守卫 watch
手表	手表 watch
怀表	怀表 watch
监视	监视 watchover
岗楼	岗楼 watchtower
浇水	浇水 water
瀑布	瀑布 waterfall
波浪	波浪 wave
挥手	挥手 wave
挥动	挥动 wave
波动	波动 wave
路途	路途 way
弱的	弱的 weak
差的	差的 weak
衰弱	衰弱 weakness
虚弱	虚弱 weakness
天气	天气 weather
婚礼	婚礼 wedding
纪念	纪念 wedding
杂草	杂草 weed
野草	野草 weed
星期	星期 week
周末	周末 weekend
哭泣	哭泣 weep
重量	重量 weight
欢迎	欢迎 welcome
泉水	泉水 well
深坑	深坑 well
西部	西部 west
西方	西方 west
湿的	湿的 wet
潮的	潮的 wet
小麦	小麦 wheat
车轮	车轮 wheel
机轮	机轮 wheel
轮椅	轮椅 wheelchair
何时	何时 when
每当	每当 whenever
随时	随时 whenever
哪些	哪些 which
抽打	抽打 whip
低语	低语 whisper
耳语	耳语 whisper
私语	私语 whisper
啸叫	啸叫 whistle
口哨	口哨 whistle
怀特	怀特 White
白色	白色 white
苍白	苍白 whiteness
谁的	谁的 whose
妻子	妻子 wife
野的	野的 wild
荒野	荒野 wild
野外	野外 wild
愿意	愿意 will willing
遗嘱	遗嘱 will
意志	意志 will
愿望	愿望 will wish
乐意	乐意 willing
获取	获取 win
卷绕	卷绕 wind
窗子	窗子 window
翅膀	翅膀 wing
冬天	冬天 winter
冬季	冬季 winter
擦净	擦净 wipe
擦干	擦干 wipe
擦去	擦去 wipeoff
电线	电线 wire
智慧	智慧 wisdom
才智	才智 wisdom
祝愿	祝愿 wish
带有	带有 with
妇女	妇女 woman
女人	女人 woman
奇迹	奇迹 wonder
奇观	奇观 wonder
树林	树林 wood
樵夫	樵夫 woodcutter
林区	林区 woodland
羊毛	羊毛 wool
单词	单词 word
干活	干活 work
著作	著作 work
作品	作品 work
工人	工人 worker
工友	工友 workmate
算出	算出 workout
世界	世界 world
蠕虫	蠕虫 worm
发愁	发愁 worry
困扰	困扰 worry
烦人	烦人 worry
崇拜	崇拜 worship
爱慕	爱慕 worship
创伤	创伤 wound
伤口	伤口 wound
摔跤	摔跤 wrestling
摔角	摔角 wrestling
手腕	手腕 wrist
书写	书写 write
写下	写下 write writedown
写信	写信 write
著述	著述 write
武术	武术 wushu
X光	X光 Xray
年年	年年 yearafteryear yearbyyear
每年	每年 yearafteryear yearbyyear
黄色	黄色 yellow
昨天	昨天 yesterday
你们	你们 you
你的	你的 your yours
陛下	陛下 YourMajesty
青春	青春 youth
青年	青年 youth
零点	零点 zero
零度	零度 zero
范围	范围 zone
做	做 act do made make take
加	加 add plus
事	事 affair
怕	怕 afraid
再	再 again
又	又 again and aswell
啊	啊 ah eh
全	全 all
都	都 all bothand
也	也 also aswell so too
是	是 am are be is yes
量	量 amount measure quantity
一	一 an one themoment
和	和 and
怒	怒 anger
踝	踝 ankle
蚁	蚁 ant
箭	箭 arrow
像	像 asas belike like
灰	灰 ash
问	问 ask
在	在 at in
但	但 atthesametime
姨	姨 aunt
姑	姑 aunt
婶	婶 aunt
醒	醒 awake wake wakeup woke woken
烤	烤 bake
烘	烘 bake
秤	秤 balance
球	球 ball globe
竹	竹 bamboo
岸	岸 bank shore
堤	堤 bank
棒	棒 bar cane stick
杆	杆 bar pole
吠	吠 bark
叫	叫 bark
浸	浸 bathe dip
洗	洗 bathe wash
湾	湾 bay
能	能 beableto can
会	会 beableto can meet meeting met should society will
豆	豆 bean
熊	熊 bear
兽	兽 beast
美	美 beauty
床	床 bed
物	物 being object
人	人 being fellow human humanbeing man people person
钟	钟 bell
铃	铃 bell
带	带 belt
兆	兆 billion
捆	捆 bind pack packet wrap
绑	绑 bind
鸟	鸟 bird
咬	咬 bite strike
血	血 blood
花	花 bloom flower
吹	吹 blow
艇	艇 boat
骨	骨 bone
书	书 book
借	借 borrow
双	双 both double
两	两 both
瓶	瓶 bottle vase
底	底 bottom
碗	碗 bowl
砖	砖 brick
桥	桥 bridge
溪	溪 brook
桶	桶 bucket
碰	碰 bump
撞	撞 bump hit
葬	葬 bury
忙	忙 busy
买	买 buy
被	被 by
由	由 by by from
用	用 by by in use
乘	乘 by multiply
最	最 byfar
笼	笼 cage
饼	饼 cake
糕	糕 cake
棍	棍 cane stick
刻	刻 carve
猫	猫 cat
捉	捉 catch seize
牛	牛 cattle
洞	洞 cave hole opening
穴	穴 cave opening
分	分 cent divide penny
好	好 certainly good OK okay well yes
链	链 chain
章	章 chapter
回	回 chapter
炭	炭 charcoal
贱	贱 cheap
嚼	嚼 chew
哽	哽 choke
噎	噎 choke
砍	砍 chop cut
伐	伐 chop
班	班 class
课	课 class lesson
爬	爬 climb crawl
关	关 close turnoff
闭	闭 close
布	布 cloth
云	云 cloud
煤	煤 coal
柱	柱 column pole
来	来 come
落	落 comedown set
洲	洲 continent
煮	煮 cook
烧	烧 cook
凉	凉 cool
弦	弦 cord
罩	罩 cover covering
套	套 covering service
榨	榨 crush
挤	挤 crush
哭	哭 cry
喊	喊 cry shout
杯	杯 cup
帘	帘 curtain
幕	幕 curtain
切	切 cut
割	割 cut
敢	敢 dare
天	天 day heaven sky
日	日 day
呵	呵 Dearme
死	死 death die loseone'slife
深	深 deep depth
鹿	鹿 deer
窝	窝 den nest
局	局 department
司	司 department
处	处 department
挖	挖 dig
掘	掘 dig pick
蘸	蘸 dip
脏	脏 dirty
病	病 disease illness
盘	盘 dish
碟	碟 dish
区	区 district
干	干 do dry
狗	狗 dog
元	元 dollar
门	门 door
下	下 down
拉	拉 drag draw pull
拖	拖 drag pull
龙	龙 dragon
画	画 draw
牵	牵 draw
图	图 drawing
梦	梦 dream
钻	钻 drill
喝	喝 drink
滴	滴 drop trickle
药	药 drug medicine medicine
鼓	鼓 drum
鸭	鸭 duck
染	染 dye
早	早 early
土	土 earth
泥	泥 earth mud
东	东 east
吃	吃 eat
边	边 edge side
版	版 edition
蛋	蛋 egg
嗯	嗯 eh er
八	八 eight
电	电 electricity
连	连 even
更	更 even
脸	脸 face
家	家 family home
快	快 fast quickly
摸	摸 feel
触	触 feel
地	地 field
满	满 fill
火	火 fire
鱼	鱼 fish
五	五 five
旗	旗 flag
肉	肉 flesh meat
粉	粉 flour powder
流	流 flow
飞	飞 fly
雾	雾 fog
傻	傻 foolish
脚	脚 foot
足	足 foot
为	为 for
往	往 for
向	向 for to toward
的	的 for of
叉	叉 fork
四	四 four
蛙	蛙 frog
从	从 from
自	自 from
距	距 from
皮	皮 fur skin
代	代 generation
逃	逃 getaway
离	离 getaway
握	握 getholdof
鳃	鳃 gill
给	给 give hand
生	生 givebirthto
胶	胶 glue
去	去 go
走	走 go walk
神	神 god
鹅	鹅 goose
抢	抢 grab
克	克 gram
草	草 grass
很	很 greatly much quilt so very
群	群 group
猜	猜 guess
枪	枪 gun
炮	炮 gun
哈	哈 ha
嘿	嘿 ha
半	半 half
手	手 hand
递	递 hand
柄	柄 handle
悬	悬 hang
挂	挂 hang
仅	仅 hardly just
才	才 hardly
有	有 has have
鹰	鹰 hawk
他	他 he him
头	头 head
听	听 hearing listen listento
心	心 heart
热	热 heat
踵	踵 heel
高	高 height high
拿	拿 held hold take
抱	抱 held hold takesthinone'sarms
喂	喂 hello hi
她	她 her she
嗨	嗨 hey hi
藏	藏 hide
打	打 hit knock strike
坑	坑 hole pit
孔	孔 hole
跳	跳 hop jump skip
马	马 horse
百	百 hundred
我	我 I me
冰	冰 ice
虫	虫 insect worm
铁	铁 iron
岛	岛 island isle
它	它 it
缸	缸 jar
颚	颚 jaw
颏	颏 jaw
琼	琼 Joan
乔	乔 Joe
汁	汁 juice
液	液 juice
踢	踢 kick
吻	吻 kiss
敲	敲 knock knockat
击	击 knock strike
放	放 laid lay put set set
搁	搁 laid lay set
躺	躺 lain lay lie
卧	卧 lain lay lie
湖	湖 lake
灯	灯 lamp
笑	笑 laugh laughter
法	法 law
铅	铅 lead
叶	叶 leaf
渗	渗 leak
靠	靠 lean
腿	腿 leg
长	长 length long
让	让 let
信	信 letter
舔	舔 lick
光	光 light
象	象 like
线	线 line thread
排	排 line
行	行 line OK
表	表 list
升	升 litre liter
装	装 load
锁	锁 lock
看	看 look lookat regard saw see seen
瞧	瞧 look
爱	爱 love
低	低 low
浅	浅 low
矮	矮 low
团	团 lump mass
肺	肺 lung
造	造 make
块	块 mass
米	米 metre meter rice
奶	奶 milk
毋	毋 Mmm
钱	钱 money
月	月 month
霉	霉 mould
山	山 mountain
鼠	鼠 mouse rat
嘴	嘴 mouth
多	多 much
钉	钉 nail
颈	颈 neck
针	针 needle
巢	巢 nest
窠	窠 nest
网	网 net web
夜	夜 night
九	九 nine
不	不 no not without
北	北 north
没	没 not
数	数 number
哦	哦 oh
油	油 oil
对	对 OK okay
只	只 only
出	出 out
氧	氧 oxygen
步	步 pace
包	包 packet wrap
页	页 page
疼	疼 pain
宫	宫 palace
纸	纸 paper
过	过 past
路	路 path road route way
型	型 pattern type
梨	梨 pear
摘	摘 pick
镐	镐 pick
张	张 piece
篇	篇 piece
首	首 piece
猪	猪 pig
堆	堆 pile
玩	玩 play
请	请 please
犁	犁 plough
耕	耕 plough
羊	羊 plsheep sheep
诗	诗 poem
点	点 point spot
指	指 point referto
极	极 pole
钋	钋 polonium
港	港 port
罐	罐 pot
锅	锅 pot
壶	壶 pot
磅	磅 pound
倒	倒 pour
注	注 pour
灌	灌 pour
权	权 power
力	力 power
省	省 province
拔	拔 pull
穿	穿 pullon puton wear
戴	戴 pullon wear
泵	泵 pump
推	推 push
摆	摆 put
贴	贴 putup
镭	镭 radium
雨	雨 rain
读	读 read
卷	卷 reel set wrap
绕	绕 reel
话	话 remark saying word
说	说 remark said say speak
还	还 return still
稻	稻 rice
右	右 right
环	环 ring
江	江 river
河	河 river
摇	摇 rock
辊	辊 roller
顶	顶 roof
根	根 root
绳	绳 rope
索	索 rope
烂	烂 rot
尺	尺 ruler
跑	跑 run
冲	冲 rush
奔	奔 rush
讲	讲 said say speak
帆	帆 sail
篷	篷 sail
卖	卖 sale sell sold
盐	盐 salt
沙	沙 sand
坐	坐 sat sit
救	救 save
抓	抓 scratch seize strike
擦	擦 scratch wipe
海	海 sea
季	季 season
座	座 seat
秒	秒 second
段	段 section
售	售 sell sold
送	送 send sent
副	副 service
镶	镶 set
嵌	嵌 set
七	七 seven
性	性 sex
棚	棚 shed
船	船 ship
鞋	鞋 shoe
苗	苗 shoot
芽	芽 shoot
滨	滨 shore
将	将 should will
面	面 side
见	见 sight
丝	丝 silk
绸	绸 silk
绢	绢 silk
蚕	蚕 silkworm
银	银 silver
唱	唱 sing
六	六 six
蹦	蹦 skip
掴	掴 slap
睡	睡 sleep
滑	滑 slide
溜	溜 slip
闻	闻 smell
嗅	嗅 smell smelt
味	味 smell
烟	烟 smoke
蛇	蛇 snake
雪	雪 snow
歌	歌 song
汤	汤 soup
南	南 south
矛	矛 spear
种	种 species
泼	泼 splash
溅	溅 splash
匙	匙 spoon
喷	喷 spray
泉	泉 spring
站	站 stand station stood
星	星 star
盯	盯 stare
州	州 state
所	所 station
呆	呆 stay
偷	偷 steal
汽	汽 steam
钢	钢 steel
茎	茎 stem
伸	伸 stick
塞	塞 stick
胃	胃 stomach
街	街 street
糖	糖 sugar
吞	吞 swallow
咽	咽 swallow
汗	汗 sweat
扫	扫 sweep swept
游	游 swim
剑	剑 sword
刀	刀 sword
取	取 take
槽	槽 tank
教	教 taught teach
税	税 tax
茶	茶 tea
队	队 team
组	组 team
十	十 ten
词	词 term word
比	比 than
那	那 that
就	就 themoment
贼	贼 thief
想	想 think thought
渴	渴 thirst
这	这 this
千	千 thousand
三	三 three
投	投 threw throw thrown
掷	掷 threw throw thrown
扔	扔 threw throw thrown
刺	刺 thrust
戳	戳 thrust
插	插 thrust
票	票 ticket
券	券 ticket
潮	潮 tide
系	系 tie
拴	拴 tie
扎	扎 tie
次	次 time
梢	梢 tip
尖	尖 tip
累	累 tired
到	到 to
吨	吨 ton
舌	舌 tongue
太	太 too
朝	朝 toward
塔	塔 tower
树	树 tree
试	试 try
翻	翻 turn turnover
转	转 turn
开	开 turnon
拧	拧 twist
二	二 two
式	式 type
伞	伞 umbrella
叔	叔 uncle
伯	伯 uncle
舅	舅 uncle
铀	铀 uranium
气	气 vapour
藤	藤 vine
醋	醋 vinegar
善	善 virtue
德	德 virtue
腰	腰 waist
等	等 wait
墙	墙 wall
要	要 want will
水	水 water
波	波 wave
蜡	蜡 wax
织	织 weave
编	编 weave
周	周 week
重	重 weigh weight
井	井 well
西	西 west
鲸	鲸 whale
轮	轮 wheel
白	白 whiteness
谁	谁 who whom
风	风 wind
窗	窗 window
酒	酒 wine
翅	翅 wing
翼	翼 wing
愿	愿 wish
无	无 without
狼	狼 wolf
坏	坏 wrong
