にっこり笑う	にっこり笑う 😀
にやっと笑う	にやっと笑う 😁
嬉し泣き	嬉し泣き 😂
わーい	わーい 😃
笑顔	笑顔 😄
冷や汗笑顔	冷や汗笑顔 😅
きゃー	きゃー 😆
天使の輪がついた笑顔	天使の輪がついた笑顔 😇
ウインク	ウインク 😉
にこにこ	にこにこ 😊
微笑む	微笑む 🙂
さかさまの顔	さかさまの顔 🙃
笑い転げる	笑い転げる 🤣
スマイリー	スマイリー ☺
目がハートの笑顔	目がハートの笑顔 😍
キス	キス 😗
投げキッス	投げキッス 😘
にっこりキス	にっこりキス 😙
ちゅっ	ちゅっ 😚
目が星の笑顔	目が星の笑顔 🤩
ハートの笑顔	ハートの笑顔 🥰
嬉し涙の顔	嬉し涙の顔 🥲
にこにこぺろり	にこにこぺろり 😋
舌を出した顔	舌を出した顔 😛
あっかんべー	あっかんべー 😜
目を閉じてべー	目を閉じてべー 😝
お金の顔	お金の顔 🤑
ふざけた顔	ふざけた顔 🤪
考える顔	考える顔 🤔
ハグ	ハグ 🤗
しーっ	しーっ 🤫
口に手を当てた顔	口に手を当てた顔 🤭
薄笑いをする顔	薄笑いをする顔 😏
ポーカーフェイス	ポーカーフェイス 😐
無表情	無表情 😑
しらけた	しらけた 😒
しかめ面	しかめ面 😬
息を吐く顔	息を吐く顔 😮‍💨
口のない顔	口のない顔 😶
雲の中の顔	雲の中の顔 😶‍🌫️
上を見る顔	上を見る顔 🙄
口チャック	口チャック 🤐
うそつきの顔	うそつきの顔 🤥
眉を上げた顔	眉を上げた顔 🤨
ほっとした顔	ほっとした顔 😌
しょぼーん	しょぼーん 😔
眠い	眠い 😪
寝る	寝る 😴
よだれを垂らした顔	よだれを垂らした顔 🤤
めまい	めまい 😵
目を回した顔	目を回した顔 😵‍💫
マスク顔	マスク顔 😷
熱がある顔	熱がある顔 🤒
包帯を巻いた顔	包帯を巻いた顔 🤕
吐き気の顔	吐き気の顔 🤢
くしゃみする顔	くしゃみする顔 🤧
嘔吐する顔	嘔吐する顔 🤮
頭爆発	頭爆発 🤯
ふらふらの顔	ふらふらの顔 🥴
暑い顔	暑い顔 🥵
寒い顔	寒い顔 🥶
カウボーイの顔	カウボーイの顔 🤠
パーティーの顔	パーティーの顔 🥳
変装した顔	変装した顔 🥸
サングラスで笑顔	サングラスで笑顔 😎
オタク	オタク 🤓
モノクルを付けた顔	モノクルを付けた顔 🧐
困った顔	困った顔 ☹
冷や汗	冷や汗 😓
混乱	混乱 😕
困惑した顔	困惑した顔 😖
失望した顔	失望した顔 😞
悩む顔	悩む顔 😟
泣き顔	泣き顔 😢
我慢	我慢 😣
どうしよう	どうしよう 😥
あきれ顔	あきれ顔 😦
苦悩	苦悩 😧
青ざめ	青ざめ 😨
あきらめ	あきらめ 😩
疲れた	疲れた 😫
大泣き	大泣き 😭
口が開いた顔	口が開いた顔 😮
ぽかーん	ぽかーん 😯
冷や汗青ざめ	冷や汗青ざめ 😰
恐怖	恐怖 😱
びっくり	びっくり 😲
赤面	赤面 😳
少し困った顔	少し困った顔 🙁
あくびした顔	あくびした顔 🥱
訴えるような顔	訴えるような顔 🥺
ドクロと骨	ドクロと骨 ☠
怒った悪魔	怒った悪魔 👿
ドクロ	ドクロ 💀
笑った悪魔	笑った悪魔 😈
ぷんぷん	ぷんぷん 😠
ふくれっ面	ふくれっ面 😡
勝ち誇った顔	勝ち誇った顔 😤
ののしる	ののしる 🤬
鬼	鬼 👹
天狗	天狗 👺
お化け	お化け 👻
エイリアン	エイリアン 👽
インベーダー	インベーダー 👾
うんち	うんち 💩
ロボット	ロボット 🤖
ピエロの顔	ピエロの顔 🤡
にやっと笑う猫	にやっと笑う猫 😸
嬉し泣きする猫	嬉し泣きする猫 😹
にっこり笑う猫	にっこり笑う猫 😺
目がハートの猫	目がハートの猫 😻
にやりとする猫	にやりとする猫 😼
猫のキス	猫のキス 😽
不機嫌な猫	不機嫌な猫 😾
泣いている猫	泣いている猫 😿
絶望する猫	絶望する猫 🙀
見ざる	見ざる 🙈
聞かざる	聞かざる 🙉
言わざる	言わざる 🙊
ハートのびっくり	ハートのびっくり ❣
赤いハート	赤いハート ❤
燃えるハート	燃えるハート ❤️‍🔥
包帯を巻いたハート	包帯を巻いたハート ❤️‍🩹
吹き出しの目	吹き出しの目 👁️‍🗨️
キスマーク	キスマーク 💋
ラブレター	ラブレター 💌
ドキドキするハート	ドキドキするハート 💓
割れたハート	割れたハート 💔
2つのハート	2つのハート 💕
きらきらハート	きらきらハート 💖
大きくなるハート	大きくなるハート 💗
ハートに矢	ハートに矢 💘
青いハート	青いハート 💙
緑のハート	緑のハート 💚
黄色のハート	黄色のハート 💛
紫のハート	紫のハート 💜
ハートにリボン	ハートにリボン 💝
回転するハート	回転するハート 💞
ハートデコ	ハートデコ 💟
むかっ	むかっ 💢
爆弾	爆弾 💣
グーグー	グーグー 💤
衝突	衝突 💥
あせあせ	あせあせ 💦
ダッシュ	ダッシュ 💨
くらくら	くらくら 💫
会話の吹き出し	会話の吹き出し 💬
雲形の吹き出し	雲形の吹き出し 💭
100点満点	100点満点 💯
穴	穴 🕳
黒いハート	黒いハート 🖤
吹き出し左	吹き出し左 🗨
怒りの吹き出し	怒りの吹き出し 🗯
白いハート	白いハート 🤍
茶色いハート	茶色いハート 🤎
オレンジのハート	オレンジのハート 🧡
挙手	挙手 ✋
手を振る	手を振る 👋
開いた手	開いた手 🖐
バルカンの挨拶	バルカンの挨拶 🖖
手の甲	手の甲 🤚
Vサイン	Vサイン ✌
OKの手	OKの手 👌
上向きにすぼめた手	上向きにすぼめた手 🤌
つまんでいる指	つまんでいる指 🤏
角の指サイン	角の指サイン 🤘
電話の合図	電話の合図 🤙
指をクロス	指をクロス 🤞
アイラブユー	アイラブユー 🤟
上指差し	上指差し ☝
手の甲上指差し	手の甲上指差し 👆
下指差し	下指差し 👇
左指差し	左指差し 👈
右指差し	右指差し 👉
立てた中指	立てた中指 🖕
げんこつ	げんこつ ✊
グー	グー 👊
サムズアップ	サムズアップ 👍
サムズダウン	サムズダウン 👎
左向きのこぶし	左向きのこぶし 🤛
右向きのこぶし	右向きのこぶし 🤜
拍手	拍手 👏
両手のひら	両手のひら 👐
バンザイ	バンザイ 🙌
祈り	祈り 🙏
握手	握手 🤝
手のひらを揃えた両手	手のひらを揃えた両手 🤲
書いている手	書いている手 ✍
マニキュアを塗る手	マニキュアを塗る手 💅
セルフィー	セルフィー 🤳
目	目 👀
片目	片目 👁
耳	耳 👂
鼻	鼻 👃
口	口 👄
舌	舌 👅
力こぶ	力こぶ 💪
骨	骨 🦴
脚	脚 🦵
足	足 🦶
歯	歯 🦷
補聴器を付けた耳	補聴器を付けた耳 🦻
義手	義手 🦾
義足	義足 🦿
脳	脳 🧠
心臓	心臓 🫀
肺	肺 🫁
男の子	男の子 👦
女の子	女の子 👧
男の人	男の人 👨
男性: 赤毛	男性: 赤毛 👨‍🦰
男性: 巻き毛	男性: 巻き毛 👨‍🦱
男性: はげ頭	男性: はげ頭 👨‍🦲
男性: 白髪	男性: 白髪 👨‍🦳
女の人	女の人 👩
女性: 赤毛	女性: 赤毛 👩‍🦰
女性: 巻き毛	女性: 巻き毛 👩‍🦱
女性: はげ頭	女性: はげ頭 👩‍🦲
女性: 白髪	女性: 白髪 👩‍🦳
金髪の人	金髪の人 👱
金髪の女性	金髪の女性 👱‍♀️
金髪の男性	金髪の男性 👱‍♂️
おじいさん	おじいさん 👴
おばあさん	おばあさん 👵
赤ん坊	赤ん坊 👶
大人	大人 🧑
大人: 赤毛	大人: 赤毛 🧑‍🦰
大人: 巻き毛	大人: 巻き毛 🧑‍🦱
大人: はげ頭	大人: はげ頭 🧑‍🦲
大人: 白髪	大人: 白髪 🧑‍🦳
子供	子供 🧒
お年寄り	お年寄り 🧓
あごひげの人	あごひげの人 🧔
あごひげの女性	あごひげの女性 🧔‍♀️
あごひげの男性	あごひげの男性 🧔‍♂️
案内する人	案内する人 💁
案内する女	案内する女 💁‍♀️
案内する男	案内する男 💁‍♂️
ダメのポーズをする人	ダメのポーズをする人 🙅
ダメのポーズをする女	ダメのポーズをする女 🙅‍♀️
ダメのポーズをする男	ダメのポーズをする男 🙅‍♂️
OKのポーズをする人	OKのポーズをする人 🙆
OKのポーズをする女	OKのポーズをする女 🙆‍♀️
OKのポーズをする男	OKのポーズをする男 🙆‍♂️
おじぎする人	おじぎする人 🙇
おじぎする女	おじぎする女 🙇‍♀️
おじぎする男	おじぎする男 🙇‍♂️
手を挙げる人	手を挙げる人 🙋
手を挙げる女	手を挙げる女 🙋‍♀️
手を挙げる男	手を挙げる男 🙋‍♂️
しかめ面の人	しかめ面の人 🙍
しかめ面の女	しかめ面の女 🙍‍♀️
しかめ面の男	しかめ面の男 🙍‍♂️
不機嫌な人	不機嫌な人 🙎
不機嫌な女	不機嫌な女 🙎‍♀️
不機嫌な男	不機嫌な男 🙎‍♂️
ひたいに手をあてる人	ひたいに手をあてる人 🤦
ひたいに手をあてる女	ひたいに手をあてる女 🤦‍♀️
ひたいに手をあてる男	ひたいに手をあてる男 🤦‍♂️
お手上げする人	お手上げする人 🤷
お手上げする女	お手上げする女 🤷‍♀️
お手上げする男	お手上げする男 🤷‍♂️
耳の不自由な人	耳の不自由な人 🧏
耳の不自由な女性	耳の不自由な女性 🧏‍♀️
耳の不自由な男性	耳の不自由な男性 🧏‍♂️
男性の医者	男性の医者 👨‍⚕️
男性の裁判官	男性の裁判官 👨‍⚖️
男性パイロット	男性パイロット 👨‍✈️
農家の男性	農家の男性 👨‍🌾
男性のコック	男性のコック 👨‍🍳
授乳する男性	授乳する男性 👨‍🍼
男子学生	男子学生 👨‍🎓
男性歌手	男性歌手 👨‍🎤
男性の芸術家	男性の芸術家 👨‍🎨
男性の教師	男性の教師 👨‍🏫
男性の溶接工	男性の溶接工 👨‍🏭
男性技術者	男性技術者 👨‍💻
男性会社員	男性会社員 👨‍💼
男性の整備士	男性の整備士 👨‍🔧
男性科学者	男性科学者 👨‍🔬
男性宇宙飛行士	男性宇宙飛行士 👨‍🚀
男性消防士	男性消防士 👨‍🚒
女性の医者	女性の医者 👩‍⚕️
女性の裁判官	女性の裁判官 👩‍⚖️
女性パイロット	女性パイロット 👩‍✈️
農家の女性	農家の女性 👩‍🌾
女性のコック	女性のコック 👩‍🍳
授乳する女性	授乳する女性 👩‍🍼
女子学生	女子学生 👩‍🎓
女性歌手	女性歌手 👩‍🎤
女性の芸術家	女性の芸術家 👩‍🎨
女性の教師	女性の教師 👩‍🏫
女性の溶接工	女性の溶接工 👩‍🏭
女性技術者	女性技術者 👩‍💻
女性会社員	女性会社員 👩‍💼
女性の整備士	女性の整備士 👩‍🔧
女性科学者	女性科学者 👩‍🔬
女性宇宙飛行士	女性宇宙飛行士 👩‍🚀
女性消防士	女性消防士 👩‍🚒
警察官	警察官 👮
女性警察官	女性警察官 👮‍♀️
男性警察官	男性警察官 👮‍♂️
ベールの人	ベールの人 👰
ベールの女性	ベールの女性 👰‍♀️
ベールの男性	ベールの男性 👰‍♂️
中華帽の男性	中華帽の男性 👲
ターバンの人	ターバンの人 👳
ターバンの女性	ターバンの女性 👳‍♀️
ターバンの男性	ターバンの男性 👳‍♂️
建設作業員	建設作業員 👷
女性の建設作業員	女性の建設作業員 👷‍♀️
男性の建設作業員	男性の建設作業員 👷‍♂️
プリンセス	プリンセス 👸
衛兵	衛兵 💂
女性の衛兵	女性の衛兵 💂‍♀️
男性の衛兵	男性の衛兵 💂‍♂️
探偵	探偵 🕵
女性の探偵	女性の探偵 🕵️‍♀️
男性の探偵	男性の探偵 🕵️‍♂️
妊婦	妊婦 🤰
授乳	授乳 🤱
プリンス	プリンス 🤴
タキシードの人	タキシードの人 🤵
タキシードの女性	タキシードの女性 🤵‍♀️
タキシードの男性	タキシードの男性 🤵‍♂️
忍者	忍者 🥷
医者	医者 🧑‍⚕️
裁判官	裁判官 🧑‍⚖️
パイロット	パイロット 🧑‍✈️
農家	農家 🧑‍🌾
コック	コック 🧑‍🍳
授乳する人	授乳する人 🧑‍🍼
学生	学生 🧑‍🎓
歌手	歌手 🧑‍🎤
芸術家	芸術家 🧑‍🎨
教師	教師 🧑‍🏫
溶接工	溶接工 🧑‍🏭
技術者	技術者 🧑‍💻
会社員	会社員 🧑‍💼
整備士	整備士 🧑‍🔧
科学者	科学者 🧑‍🔬
宇宙飛行士	宇宙飛行士 🧑‍🚀
消防士	消防士 🧑‍🚒
スカーフの女性	スカーフの女性 🧕
サンタ	サンタ 🎅
天使	天使 👼
女性のサンタ	女性のサンタ 🤶
スーパーヒーロー	スーパーヒーロー 🦸
女性のスーパーヒーロー	女性のスーパーヒーロー 🦸‍♀️
男性のスーパーヒーロー	男性のスーパーヒーロー 🦸‍♂️
悪役	悪役 🦹
女性の悪役	女性の悪役 🦹‍♀️
男性の悪役	男性の悪役 🦹‍♂️
サンタさん	サンタさん 🧑‍🎄
魔法使い	魔法使い 🧙
女の魔法使い	女の魔法使い 🧙‍♀️
男の魔法使い	男の魔法使い 🧙‍♂️
妖精	妖精 🧚
女の妖精	女の妖精 🧚‍♀️
男の妖精	男の妖精 🧚‍♂️
吸血鬼	吸血鬼 🧛
女の吸血鬼	女の吸血鬼 🧛‍♀️
男の吸血鬼	男の吸血鬼 🧛‍♂️
人魚	人魚 🧜
マーメイド	マーメイド 🧜‍♀️
マーマン	マーマン 🧜‍♂️
エルフ	エルフ 🧝
女のエルフ	女のエルフ 🧝‍♀️
男のエルフ	男のエルフ 🧝‍♂️
精霊	精霊 🧞
女の精霊	女の精霊 🧞‍♀️
男の精霊	男の精霊 🧞‍♂️
ゾンビ	ゾンビ 🧟
女のゾンビ	女のゾンビ 🧟‍♀️
男のゾンビ	男のゾンビ 🧟‍♂️
走る人	走る人 🏃
走る女	走る女 🏃‍♀️
走る男	走る男 🏃‍♂️
杖をついた男性	杖をついた男性 👨‍🦯
電動車椅子の男性	電動車椅子の男性 👨‍🦼
手動式車椅子の男性	手動式車椅子の男性 👨‍🦽
杖をついた女性	杖をついた女性 👩‍🦯
電動車椅子の女性	電動車椅子の女性 👩‍🦼
手動式車椅子の女性	手動式車椅子の女性 👩‍🦽
バニー	バニー 👯
バニーガール	バニーガール 👯‍♀️
バニーボーイ	バニーボーイ 👯‍♂️
踊る女	踊る女 💃
フェイスマッサージ中の人	フェイスマッサージ中の人 💆
フェイスマッサージ中の女	フェイスマッサージ中の女 💆‍♀️
フェイスマッサージ中の男	フェイスマッサージ中の男 💆‍♂️
散髪される人	散髪される人 💇
散髪される女	散髪される女 💇‍♀️
散髪される男	散髪される男 💇‍♂️
浮いてるビジネスマン	浮いてるビジネスマン 🕴
踊る男	踊る男 🕺
歩く人	歩く人 🚶
歩く女	歩く女 🚶‍♀️
歩く男	歩く男 🚶‍♂️
立つ人	立つ人 🧍
立つ女	立つ女 🧍‍♀️
立つ男	立つ男 🧍‍♂️
正座する人	正座する人 🧎
正座する女性	正座する女性 🧎‍♀️
正座する男性	正座する男性 🧎‍♂️
杖をついた人	杖をついた人 🧑‍🦯
電動車椅子の人	電動車椅子の人 🧑‍🦼
手動式車椅子の人	手動式車椅子の人 🧑‍🦽
サウナに入る人	サウナに入る人 🧖
サウナに入る女	サウナに入る女 🧖‍♀️
サウナに入る男	サウナに入る男 🧖‍♂️
山を登る人	山を登る人 🧗
山を登る女	山を登る女 🧗‍♀️
山を登る男	山を登る男 🧗‍♂️
スキーヤー	スキーヤー ⛷
バスケットボールをする人	バスケットボールをする人 ⛹
バスケットボールをする女	バスケットボールをする女 ⛹️‍♀️
バスケットボールをする男	バスケットボールをする男 ⛹️‍♂️
スノーボーダー	スノーボーダー 🏂
サーフィンする人	サーフィンする人 🏄
サーフィンする女	サーフィンする女 🏄‍♀️
サーフィンする男	サーフィンする男 🏄‍♂️
競馬	競馬 🏇
泳ぐ人	泳ぐ人 🏊
泳ぐ女	泳ぐ女 🏊‍♀️
泳ぐ男	泳ぐ男 🏊‍♂️
重量挙げをする人	重量挙げをする人 🏋
重量挙げをする女	重量挙げをする女 🏋️‍♀️
重量挙げをする男	重量挙げをする男 🏋️‍♂️
ゴルフをする人	ゴルフをする人 🏌
ゴルフをする女	ゴルフをする女 🏌️‍♀️
ゴルフをする男	ゴルフをする男 🏌️‍♂️
ボートをこぐ人	ボートをこぐ人 🚣
ボートをこぐ女	ボートをこぐ女 🚣‍♀️
ボートをこぐ男	ボートをこぐ男 🚣‍♂️
自転車に乗る人	自転車に乗る人 🚴
自転車に乗る女	自転車に乗る女 🚴‍♀️
自転車に乗る男	自転車に乗る男 🚴‍♂️
マウンテンバイクに乗る人	マウンテンバイクに乗る人 🚵
マウンテンバイクに乗る女	マウンテンバイクに乗る女 🚵‍♀️
マウンテンバイクに乗る男	マウンテンバイクに乗る男 🚵‍♂️
側転する人	側転する人 🤸
側転する女	側転する女 🤸‍♀️
側転する男	側転する男 🤸‍♂️
ジャグリングをする人	ジャグリングをする人 🤹
ジャグリングをする女	ジャグリングをする女 🤹‍♀️
ジャグリングをする男	ジャグリングをする男 🤹‍♂️
フェンシングをする人	フェンシングをする人 🤺
レスリングする人	レスリングする人 🤼
レスリングする女	レスリングする女 🤼‍♀️
レスリングする男	レスリングする男 🤼‍♂️
水球をする人	水球をする人 🤽
水球をする女	水球をする女 🤽‍♀️
水球をする男	水球をする男 🤽‍♂️
ハンドボールをする人	ハンドボールをする人 🤾
ハンドボールをする女	ハンドボールをする女 🤾‍♀️
ハンドボールをする男	ハンドボールをする男 🤾‍♂️
風呂に入る人	風呂に入る人 🛀
ベッドに寝る人	ベッドに寝る人 🛌
ヨガのポーズをする人	ヨガのポーズをする人 🧘
ヨガのポーズをする女	ヨガのポーズをする女 🧘‍♀️
ヨガのポーズをする男	ヨガのポーズをする男 🧘‍♂️
カップルとハート: 男性 男性	カップルとハート: 男性 男性 👨‍❤️‍👨
2人でキス: 男性 男性	2人でキス: 男性 男性 👨‍❤️‍💋‍👨
家族: 男性 男の子	家族: 男性 男の子 👨‍👦
家族: 男性 男の子 男の子	家族: 男性 男の子 男の子 👨‍👦‍👦
家族: 男性 女の子	家族: 男性 女の子 👨‍👧
家族: 男性 女の子 男の子	家族: 男性 女の子 男の子 👨‍👧‍👦
家族: 男性 女の子 女の子	家族: 男性 女の子 女の子 👨‍👧‍👧
家族: 男性 男性 男の子	家族: 男性 男性 男の子 👨‍👨‍👦
家族: 男性 男性 男の子 男の子	家族: 男性 男性 男の子 男の子 👨‍👨‍👦‍👦
家族: 男性 男性 女の子	家族: 男性 男性 女の子 👨‍👨‍👧
家族: 男性 男性 女の子 男の子	家族: 男性 男性 女の子 男の子 👨‍👨‍👧‍👦
家族: 男性 男性 女の子 女の子	家族: 男性 男性 女の子 女の子 👨‍👨‍👧‍👧
家族: 男性 女性 男の子	家族: 男性 女性 男の子 👨‍👩‍👦
家族: 男性 女性 男の子 男の子	家族: 男性 女性 男の子 男の子 👨‍👩‍👦‍👦
家族: 男性 女性 女の子	家族: 男性 女性 女の子 👨‍👩‍👧
家族: 男性 女性 女の子 男の子	家族: 男性 女性 女の子 男の子 👨‍👩‍👧‍👦
家族: 男性 女性 女の子 女の子	家族: 男性 女性 女の子 女の子 👨‍👩‍👧‍👧
カップルとハート: 女性 男性	カップルとハート: 女性 男性 👩‍❤️‍👨
カップルとハート: 女性 女性	カップルとハート: 女性 女性 👩‍❤️‍👩
2人でキス: 女性 男性	2人でキス: 女性 男性 👩‍❤️‍💋‍👨
2人でキス: 女性 女性	2人でキス: 女性 女性 👩‍❤️‍💋‍👩
家族: 女性 男の子	家族: 女性 男の子 👩‍👦
家族: 女性 男の子 男の子	家族: 女性 男の子 男の子 👩‍👦‍👦
家族: 女性 女の子	家族: 女性 女の子 👩‍👧
家族: 女性 女の子 男の子	家族: 女性 女の子 男の子 👩‍👧‍👦
家族: 女性 女の子 女の子	家族: 女性 女の子 女の子 👩‍👧‍👧
家族: 女性 女性 男の子	家族: 女性 女性 男の子 👩‍👩‍👦
家族: 女性 女性 男の子 男の子	家族: 女性 女性 男の子 男の子 👩‍👩‍👦‍👦
家族: 女性 女性 女の子	家族: 女性 女性 女の子 👩‍👩‍👧
家族: 女性 女性 女の子 男の子	家族: 女性 女性 女の子 男の子 👩‍👩‍👧‍👦
家族: 女性 女性 女の子 女の子	家族: 女性 女性 女の子 女の子 👩‍👩‍👧‍👧
家族	家族 👪
手をつなぐ男女	手をつなぐ男女 👫
手をつなぐ男性	手をつなぐ男性 👬
手をつなぐ女性	手をつなぐ女性 👭
2人でキス	2人でキス 💏
カップルとハート	カップルとハート 💑
手をつなぐ2人	手をつなぐ2人 🧑‍🤝‍🧑
足あと	足あと 👣
人のシルエット	人のシルエット 👤
2人のシルエット	2人のシルエット 👥
話す人のシルエット	話す人のシルエット 🗣
ハグする人	ハグする人 🫂
肌色	肌色 🏽
赤毛	赤毛 🦰
巻き毛	巻き毛 🦱
はげ頭	はげ頭 🦲
白髪	白髪 🦳
ネズミ	ネズミ 🐀
ハツカネズミ	ハツカネズミ 🐁
牡牛	牡牛 🐂
水牛	水牛 🐃
牝牛	牝牛 🐄
トラ	トラ 🐅
ヒョウ	ヒョウ 🐆
ウサギ	ウサギ 🐇
ネコ	ネコ 🐈
黒猫	黒猫 🐈‍⬛
馬	馬 🐎
牡羊	牡羊 🐏
山羊	山羊 🐐
羊	羊 🐑
サル	サル 🐒
イヌ	イヌ 🐕
介助犬	介助犬 🐕‍🦺
ブタ	ブタ 🐖
イノシシ	イノシシ 🐗
ゾウ	ゾウ 🐘
コアラ	コアラ 🐨
プードル	プードル 🐩
ラクダ	ラクダ 🐪
フタコブラクダ	フタコブラクダ 🐫
ネズミの顔	ネズミの顔 🐭
牛の顔	牛の顔 🐮
トラの顔	トラの顔 🐯
ウサギの顔	ウサギの顔 🐰
ネコの顔	ネコの顔 🐱
馬の顔	馬の顔 🐴
サルの顔	サルの顔 🐵
イヌの顔	イヌの顔 🐶
ブタの顔	ブタの顔 🐷
ハムスターの顔	ハムスターの顔 🐹
オオカミの顔	オオカミの顔 🐺
クマの顔	クマの顔 🐻
シロクマ	シロクマ 🐻‍❄️
パンダの顔	パンダの顔 🐼
ブタ鼻	ブタ鼻 🐽
肉球	肉球 🐾
リス	リス 🐿
ライオンの顔	ライオンの顔 🦁
ユニコーンの顔	ユニコーンの顔 🦄
コウモリ	コウモリ 🦇
キツネの顔	キツネの顔 🦊
シカ	シカ 🦌
ゴリラ	ゴリラ 🦍
サイ	サイ 🦏
キリン	キリン 🦒
シマウマ	シマウマ 🦓
ハリネズミ	ハリネズミ 🦔
カンガルー	カンガルー 🦘
ラマ	ラマ 🦙
カバ	カバ 🦛
アライグマ	アライグマ 🦝
アナグマ	アナグマ 🦡
マンモス	マンモス 🦣
ナマケモノ	ナマケモノ 🦥
カワウソ	カワウソ 🦦
オランウータン	オランウータン 🦧
スカンク	スカンク 🦨
ビーバー	ビーバー 🦫
バイソン	バイソン 🦬
盲導犬	盲導犬 🦮
おんどり	おんどり 🐓
にわとり	にわとり 🐔
卵からかえったひよこ	卵からかえったひよこ 🐣
ひよこ	ひよこ 🐤
前を向いているひよこ	前を向いているひよこ 🐥
鳥	鳥 🐦
ペンギン	ペンギン 🐧
ハト	ハト 🕊
七面鳥	七面鳥 🦃
ワシ	ワシ 🦅
カモ	カモ 🦆
フクロウ	フクロウ 🦉
クジャク	クジャク 🦚
オウム	オウム 🦜
白鳥	白鳥 🦢
ドードー	ドードー 🦤
フラミンゴ	フラミンゴ 🦩
羽	羽 🪶
カエルの顔	カエルの顔 🐸
ドラゴン	ドラゴン 🐉
ワニ	ワニ 🐊
ヘビ	ヘビ 🐍
カメ	カメ 🐢
ドラゴンの顔	ドラゴンの顔 🐲
トカゲ	トカゲ 🦎
草食恐竜	草食恐竜 🦕
ティラノサウルス	ティラノサウルス 🦖
クジラ	クジラ 🐋
タコ	タコ 🐙
巻き貝	巻き貝 🐚
魚	魚 🐟
熱帯魚	熱帯魚 🐠
フグ	フグ 🐡
イルカ	イルカ 🐬
潮吹きクジラ	潮吹きクジラ 🐳
サメ	サメ 🦈
アザラシ	アザラシ 🦭
かたつむり	かたつむり 🐌
毛虫	毛虫 🐛
アリ	アリ 🐜
ミツバチ	ミツバチ 🐝
テントウムシ	テントウムシ 🐞
クモ	クモ 🕷
クモの巣	クモの巣 🕸
サソリ	サソリ 🦂
チョウ	チョウ 🦋
バッタ	バッタ 🦗
蚊	蚊 🦟
微生物	微生物 🦠
ハエ	ハエ 🪰
ミミズ	ミミズ 🪱
カブトムシ	カブトムシ 🪲
ゴキブリ	ゴキブリ 🪳
チューリップ	チューリップ 🌷
桜	桜 🌸
バラ	バラ 🌹
ハイビスカス	ハイビスカス 🌺
ヒマワリ	ヒマワリ 🌻
開花	開花 🌼
花飾り	花飾り 🏵
花束	花束 💐
大変よくできました	大変よくできました 💮
しおれた花	しおれた花 🥀
クローバー	クローバー ☘
新芽	新芽 🌱
常緑樹	常緑樹 🌲
落葉樹	落葉樹 🌳
ヤシの木	ヤシの木 🌴
サボテン	サボテン 🌵
稲	稲 🌾
ハーブ	ハーブ 🌿
四つ葉のクローバー	四つ葉のクローバー 🍀
かえで	かえで 🍁
落ち葉	落ち葉 🍂
風に揺れる葉	風に揺れる葉 🍃
鉢植え	鉢植え 🪴
トマト	トマト 🍅
ぶどう	ぶどう 🍇
メロン	メロン 🍈
スイカ	スイカ 🍉
みかん	みかん 🍊
レモン	レモン 🍋
バナナ	バナナ 🍌
パイナップル	パイナップル 🍍
赤リンゴ	赤リンゴ 🍎
青リンゴ	青リンゴ 🍏
洋ナシ	洋ナシ 🍐
桃	桃 🍑
さくらんぼ	さくらんぼ 🍒
いちご	いちご 🍓
キウイフルーツ	キウイフルーツ 🥝
ココナツ	ココナツ 🥥
マンゴー	マンゴー 🥭
ブルーベリー	ブルーベリー 🫐
オリーブ	オリーブ 🫒
くり	くり 🌰
とうがらし	とうがらし 🌶
とうもろこし	とうもろこし 🌽
キノコ	キノコ 🍄
ナス	ナス 🍆
アボカド	アボカド 🥑
キュウリ	キュウリ 🥒
ジャガイモ	ジャガイモ 🥔
人参	人参 🥕
ピーナッツ	ピーナッツ 🥜
ブロッコリー	ブロッコリー 🥦
葉野菜	葉野菜 🥬
ニンニク	ニンニク 🧄
タマネギ	タマネギ 🧅
赤ピーマン	赤ピーマン 🫑
ホットドッグ	ホットドッグ 🌭
タコス	タコス 🌮
ブリトー	ブリトー 🌯
ハンバーガー	ハンバーガー 🍔
ピザ	ピザ 🍕
骨付き肉	骨付き肉 🍖
鶏もも肉	鶏もも肉 🍗
食パン	食パン 🍞
フライドポテト	フライドポテト 🍟
なべ	なべ 🍲
料理	料理 🍳
ポップコーン	ポップコーン 🍿
クロワッサン	クロワッサン 🥐
ベーコン	ベーコン 🥓
バゲット	バゲット 🥖
グリーンサラダ	グリーンサラダ 🥗
パエリア	パエリア 🥘
ケバブサンド	ケバブサンド 🥙
卵	卵 🥚
パンケーキ	パンケーキ 🥞
ボウルとスプーン	ボウルとスプーン 🥣
プレッツェル	プレッツェル 🥨
ステーキ肉	ステーキ肉 🥩
サンドイッチ	サンドイッチ 🥪
缶詰	缶詰 🥫
ベーグル	ベーグル 🥯
チーズ	チーズ 🧀
塩	塩 🧂
ファラフェル	ファラフェル 🧆
ワッフル	ワッフル 🧇
バター	バター 🧈
フラットブレッド	フラットブレッド 🫓
タマル	タマル 🫔
フォンデュ	フォンデュ 🫕
せんべい	せんべい 🍘
おにぎり	おにぎり 🍙
ごはん	ごはん 🍚
カレーライス	カレーライス 🍛
ラーメン	ラーメン 🍜
スパゲッティ	スパゲッティ 🍝
焼き芋	焼き芋 🍠
だんご	だんご 🍡
おでん	おでん 🍢
すし	すし 🍣
エビフライ	エビフライ 🍤
なると	なると 🍥
弁当	弁当 🍱
点心	点心 🥟
フォーチュンクッキー	フォーチュンクッキー 🥠
テイクアウト弁当	テイクアウト弁当 🥡
月餅	月餅 🥮
カニ	カニ 🦀
エビ	エビ 🦐
イカ	イカ 🦑
ザリガニ	ザリガニ 🦞
牡蠣	牡蠣 🦪
ソフトクリーム	ソフトクリーム 🍦
かき氷	かき氷 🍧
アイスクリーム	アイスクリーム 🍨
ドーナツ	ドーナツ 🍩
クッキー	クッキー 🍪
チョコレート	チョコレート 🍫
キャンディ	キャンディ 🍬
ぺろぺろキャンディ	ぺろぺろキャンディ 🍭
プリン	プリン 🍮
はちみつ	はちみつ 🍯
ショートケーキ	ショートケーキ 🍰
バースデーケーキ	バースデーケーキ 🎂
パイ	パイ 🥧
カップケーキ	カップケーキ 🧁
温かい飲み物	温かい飲み物 ☕
湯飲み	湯飲み 🍵
徳利	徳利 🍶
ワイングラス	ワイングラス 🍷
カクテルグラス	カクテルグラス 🍸
トロピカルドリンク	トロピカルドリンク 🍹
ビールジョッキ	ビールジョッキ 🍺
ビールで乾杯	ビールで乾杯 🍻
ほにゅう瓶	ほにゅう瓶 🍼
シャンパン	シャンパン 🍾
グラスで乾杯	グラスで乾杯 🥂
タンブラーグラス	タンブラーグラス 🥃
牛乳入りのコップ	牛乳入りのコップ 🥛
ストローカップ	ストローカップ 🥤
紙パック飲料	紙パック飲料 🧃
マテ茶	マテ茶 🧉
角氷	角氷 🧊
タピオカドリンク	タピオカドリンク 🧋
ティーポット	ティーポット 🫖
ナイフとフォーク	ナイフとフォーク 🍴
ナイフとフォークと皿	ナイフとフォークと皿 🍽
壺	壺 🏺
包丁	包丁 🔪
スプーン	スプーン 🥄
はし	はし 🥢
地球（ヨーロッパとアフリカ）	地球（ヨーロッパとアフリカ） 🌍
地球（アメリカ大陸）	地球（アメリカ大陸） 🌎
地球（アジアとオーストラリア）	地球（アジアとオーストラリア） 🌏
子午線のある地球	子午線のある地球 🌐
世界地図	世界地図 🗺
日本地図	日本地図 🗾
コンパス	コンパス 🧭
山	山 ⛰
火山	火山 🌋
雪山	雪山 🏔
キャンプ	キャンプ 🏕
ビーチパラソル	ビーチパラソル 🏖
砂漠	砂漠 🏜
無人島	無人島 🏝
国立公園	国立公園 🏞
富士山	富士山 🗻
建設中	建設中 🏗
住宅街	住宅街 🏘
廃屋	廃屋 🏚
歴史的な建物	歴史的な建物 🏛
競技場	競技場 🏟
家	家 🏠
庭付きの家	庭付きの家 🏡
オフィスビル	オフィスビル 🏢
郵便局	郵便局 🏣
西洋の郵便局	西洋の郵便局 🏤
病院	病院 🏥
銀行	銀行 🏦
ホテル	ホテル 🏨
ラブホテル	ラブホテル 🏩
コンビニ	コンビニ 🏪
学校	学校 🏫
デパート	デパート 🏬
工場	工場 🏭
城	城 🏯
西洋の城	西洋の城 🏰
結婚式	結婚式 💒
東京タワー	東京タワー 🗼
自由の女神	自由の女神 🗽
わらぶき小屋	わらぶき小屋 🛖
れんが	れんが 🧱
岩石	岩石 🪨
丸太	丸太 🪵
鳥居	鳥居 ⛩
教会	教会 ⛪
カーバ	カーバ 🕋
モスク	モスク 🕌
シナゴーグ	シナゴーグ 🕍
ヒンドゥー教の寺院	ヒンドゥー教の寺院 🛕
温泉マーク	温泉マーク ♨
噴水	噴水 ⛲
テント	テント ⛺
霧の都会	霧の都会 🌁
夜の都会	夜の都会 🌃
山から日の出	山から日の出 🌄
日の出	日の出 🌅
夕暮れの都会	夕暮れの都会 🌆
夕日	夕日 🌇
夜の橋	夜の橋 🌉
メリーゴーランド	メリーゴーランド 🎠
観覧車	観覧車 🎡
ジェットコースター	ジェットコースター 🎢
サーカス	サーカス 🎪
高層ビル	高層ビル 🏙
床屋	床屋 💈
ガソリンスタンド	ガソリンスタンド ⛽
オートバイ	オートバイ 🏍
レーシングカー	レーシングカー 🏎
蒸気機関車	蒸気機関車 🚂
電車	電車 🚃
新幹線	新幹線 🚄
0系新幹線	0系新幹線 🚅
電車正面	電車正面 🚆
地下鉄	地下鉄 🚇
ライトレール	ライトレール 🚈
駅	駅 🚉
路面電車正面	路面電車正面 🚊
路面電車	路面電車 🚋
バス	バス 🚌
バス正面	バス正面 🚍
トロリーバス	トロリーバス 🚎
バス停	バス停 🚏
マイクロバス	マイクロバス 🚐
救急車	救急車 🚑
消防車	消防車 🚒
パトカー	パトカー 🚓
パトカー正面	パトカー正面 🚔
タクシー	タクシー 🚕
タクシー正面	タクシー正面 🚖
自動車	自動車 🚗
自動車正面	自動車正面 🚘
アールブイ車	アールブイ車 🚙
トラック	トラック 🚚
トレーラー	トレーラー 🚛
トラクター	トラクター 🚜
モノレール	モノレール 🚝
登山鉄道	登山鉄道 🚞
信号横	信号横 🚥
信号縦	信号縦 🚦
工事中	工事中 🚧
パトランプ	パトランプ 🚨
自転車	自転車 🚲
止まれの標識	止まれの標識 🛑
ドラム缶	ドラム缶 🛢
高速道路	高速道路 🛣
線路	線路 🛤
キックボード	キックボード 🛴
スクーター	スクーター 🛵
スケートボード	スケートボード 🛹
三輪タクシー	三輪タクシー 🛺
軽トラック	軽トラック 🛻
ローラースケート	ローラースケート 🛼
電動車椅子	電動車椅子 🦼
手動式車椅子	手動式車椅子 🦽
錨	錨 ⚓
フェリー	フェリー ⛴
ヨット	ヨット ⛵
船	船 🚢
スピードボート	スピードボート 🚤
モーターボート	モーターボート 🛥
客船	客船 🛳
カヌー	カヌー 🛶
飛行機	飛行機 ✈
座席	座席 💺
ロケット	ロケット 🚀
ヘリコプター	ヘリコプター 🚁
懸垂式モノレール	懸垂式モノレール 🚟
ケーブルカー	ケーブルカー 🚠
ロープウェイ	ロープウェイ 🚡
小型飛行機	小型飛行機 🛩
飛行機離陸	飛行機離陸 🛫
飛行機着陸	飛行機着陸 🛬
人工衛星	人工衛星 🛰
空飛ぶ円盤	空飛ぶ円盤 🛸
パラシュート	パラシュート 🪂
ベルボーイベル	ベルボーイベル 🛎
スーツケース	スーツケース 🧳
腕時計	腕時計 ⌚
砂時計	砂時計 ⌛
目覚まし時計	目覚まし時計 ⏰
ストップウォッチ	ストップウォッチ ⏱
タイマー	タイマー ⏲
砂が落ちている砂時計	砂が落ちている砂時計 ⏳
1時	1時 🕐
2時	2時 🕑
3時	3時 🕒
4時	4時 🕓
5時	5時 🕔
6時	6時 🕕
7時	7時 🕖
8時	8時 🕗
9時	9時 🕘
10時	10時 🕙
11時	11時 🕚
12時	12時 🕛
1時半	1時半 🕜
2時半	2時半 🕝
3時半	3時半 🕞
4時半	4時半 🕟
5時半	5時半 🕠
6時半	6時半 🕡
7時半	7時半 🕢
8時半	8時半 🕣
9時半	9時半 🕤
10時半	10時半 🕥
11時半	11時半 🕦
12時半	12時半 🕧
置時計	置時計 🕰
太陽	太陽 ☀
雲	雲 ☁
傘	傘 ☂
雪だるまと雪	雪だるまと雪 ☃
彗星	彗星 ☄
傘と雨	傘と雨 ☔
高電圧	高電圧 ⚡
雪だるま	雪だるま ⛄
曇り時々晴れ	曇り時々晴れ ⛅
雷雨	雷雨 ⛈
パラソル	パラソル ⛱
雪の結晶	雪の結晶 ❄
スター	スター ⭐
渦巻き	渦巻き 🌀
閉じた傘	閉じた傘 🌂
虹	虹 🌈
波	波 🌊
天の川	天の川 🌌
新月	新月 🌑
初月	初月 🌒
上弦の月	上弦の月 🌓
十三夜月	十三夜月 🌔
満月	満月 🌕
寝待月	寝待月 🌖
下弦の月	下弦の月 🌗
有明月	有明月 🌘
三日月	三日月 🌙
顔のある新月	顔のある新月 🌚
顔のある上弦の月	顔のある上弦の月 🌛
顔のある下弦の月	顔のある下弦の月 🌜
顔のある満月	顔のある満月 🌝
顔のある太陽	顔のある太陽 🌞
きらきら星	きらきら星 🌟
流れ星	流れ星 🌠
温度計	温度計 🌡
晴れ時々曇り	晴れ時々曇り 🌤
曇り一時晴れ	曇り一時晴れ 🌥
雨時々晴れ	雨時々晴れ 🌦
雨雲	雨雲 🌧
雪雲	雪雲 🌨
雷雲	雷雲 🌩
竜巻	竜巻 🌪
霧	霧 🌫
顔のある風	顔のある風 🌬
水滴	水滴 💧
火	火 🔥
環のある惑星	環のある惑星 🪐
きらきら	きらきら ✨
リボン	リボン 🎀
プレゼント	プレゼント 🎁
ハロウィンかぼちゃ	ハロウィンかぼちゃ 🎃
クリスマスツリー	クリスマスツリー 🎄
打ち上げ花火	打ち上げ花火 🎆
線香花火	線香花火 🎇
風船	風船 🎈
クラッカー	クラッカー 🎉
くす玉	くす玉 🎊
七夕	七夕 🎋
門松	門松 🎍
ひな祭り	ひな祭り 🎎
こいのぼり	こいのぼり 🎏
風鈴	風鈴 🎐
月見	月見 🎑
リマインダーリボン	リマインダーリボン 🎗
入場券	入場券 🎟
チケット	チケット 🎫
赤い封筒	赤い封筒 🧧
爆竹	爆竹 🧨
勲章	勲章 🎖
メダル	メダル 🏅
トロフィー	トロフィー 🏆
金メダル	金メダル 🥇
銀メダル	銀メダル 🥈
銅メダル	銅メダル 🥉
サッカー	サッカー ⚽
野球	野球 ⚾
ゴルフ	ゴルフ ⛳
アイススケート	アイススケート ⛸
釣り	釣り 🎣
ボウリング	ボウリング 🎳
長距離走	長距離走 🎽
テニス	テニス 🎾
スキー	スキー 🎿
バスケットボール	バスケットボール 🏀
アメフト	アメフト 🏈
ラグビー	ラグビー 🏉
クリケット	クリケット 🏏
バレーボール	バレーボール 🏐
ホッケー	ホッケー 🏑
アイスホッケー	アイスホッケー 🏒
卓球	卓球 🏓
バドミントン	バドミントン 🏸
そり競技	そり競技 🛷
ダイビングマスク	ダイビングマスク 🤿
ゴールネット	ゴールネット 🥅
ボクシング	ボクシング 🥊
武道	武道 🥋
カーリング	カーリング 🥌
ラクロス	ラクロス 🥍
ソフトボール	ソフトボール 🥎
フリスビー	フリスビー 🥏
チェスの駒	チェスの駒 ♟
スペード	スペード ♠
クラブ	クラブ ♣
ハート	ハート ♥
ダイヤ	ダイヤ ♦
麻雀	麻雀 🀄
ジョーカー	ジョーカー 🃏
テレビゲーム	テレビゲーム 🎮
的	的 🎯
スロットマシン	スロットマシン 🎰
ビリヤード	ビリヤード 🎱
サイコロ	サイコロ 🎲
花札	花札 🎴
水晶玉	水晶玉 🔮
ジョイスティック	ジョイスティック 🕹
ジグソーパズル	ジグソーパズル 🧩
テディベア	テディベア 🧸
ナザール・ボンジュウ	ナザール・ボンジュウ 🧿
ヨーヨー	ヨーヨー 🪀
たこ	たこ 🪁
魔法の杖	魔法の杖 🪄
ピニャータ	ピニャータ 🪅
マトリョーシカ	マトリョーシカ 🪆
絵の具パレット	絵の具パレット 🎨
舞台芸術	舞台芸術 🎭
絵画	絵画 🖼
糸	糸 🧵
毛糸	毛糸 🧶
縫い針	縫い針 🪡
結び目	結び目 🪢
白十字ヘルメット	白十字ヘルメット ⛑
バックパック	バックパック 🎒
角帽	角帽 🎓
シルクハット	シルクハット 🎩
王冠	王冠 👑
婦人帽子	婦人帽子 👒
メガネ	メガネ 👓
ネクタイ	ネクタイ 👔
Tシャツ	Tシャツ 👕
ジーンズ	ジーンズ 👖
ワンピース	ワンピース 👗
着物	着物 👘
ビキニ	ビキニ 👙
婦人服	婦人服 👚
がま口	がま口 👛
ハンドバッグ	ハンドバッグ 👜
ポーチ	ポーチ 👝
紳士靴	紳士靴 👞
スニーカー	スニーカー 👟
ハイヒール	ハイヒール 👠
サンダル	サンダル 👡
ブーツ	ブーツ 👢
口紅	口紅 💄
指輪	指輪 💍
宝石	宝石 💎
数珠	数珠 📿
サングラス	サングラス 🕶
紙袋	紙袋 🛍
サリー	サリー 🥻
白衣	白衣 🥼
ゴーグル	ゴーグル 🥽
ハイキングシューズ	ハイキングシューズ 🥾
フラットシューズ	フラットシューズ 🥿
安全ベスト	安全ベスト 🦺
キャップ	キャップ 🧢
マフラー	マフラー 🧣
手袋	手袋 🧤
コート	コート 🧥
ソックス	ソックス 🧦
トウシューズ	トウシューズ 🩰
ワンピースの水着	ワンピースの水着 🩱
ブリーフ	ブリーフ 🩲
ショーツ	ショーツ 🩳
ビーチサンダル	ビーチサンダル 🩴
軍用ヘルメット	軍用ヘルメット 🪖
拡声器	拡声器 📢
メガホン	メガホン 📣
郵便ラッパ	郵便ラッパ 📯
スピーカー消音	スピーカー消音 🔇
スピーカー	スピーカー 🔈
スピーカー音量小	スピーカー音量小 🔉
スピーカー音量大	スピーカー音量大 🔊
ベル	ベル 🔔
ベル消音	ベル消音 🔕
スタジオマイク	スタジオマイク 🎙
レベルスライダー	レベルスライダー 🎚
コントロールつまみ	コントロールつまみ 🎛
マイク	マイク 🎤
ヘッドホン	ヘッドホン 🎧
音符	音符 🎵
複数の音符	複数の音符 🎶
楽譜	楽譜 🎼
ラジオ	ラジオ 📻
サックス	サックス 🎷
ギター	ギター 🎸
鍵盤	鍵盤 🎹
トランペット	トランペット 🎺
バイオリン	バイオリン 🎻
ドラム	ドラム 🥁
バンジョー	バンジョー 🪕
アコーディオン	アコーディオン 🪗
コンガ	コンガ 🪘
受話器	受話器 📞
ポケベル	ポケベル 📟
ファックス	ファックス 📠
携帯電話	携帯電話 📱
着信中	着信中 📲
キーボード	キーボード ⌨
ノートパソコン	ノートパソコン 💻
MD	MD 💽
フロッピー	フロッピー 💾
CD	CD 💿
DVD	DVD 📀
電池	電池 🔋
コンセント	コンセント 🔌
デスクトップパソコン	デスクトップパソコン 🖥
プリンタ	プリンタ 🖨
マウス	マウス 🖱
トラックボール	トラックボール 🖲
そろばん	そろばん 🧮
映画フィルム	映画フィルム 🎞
映画カメラ	映画カメラ 🎥
カチンコ	カチンコ 🎬
赤ちょうちん	赤ちょうちん 🏮
電球	電球 💡
カメラ	カメラ 📷
フラッシュを焚いているカメラ	フラッシュを焚いているカメラ 📸
ビデオカメラ	ビデオカメラ 📹
テレビ	テレビ 📺
ビデオテープ	ビデオテープ 📼
映写機	映写機 📽
虫眼鏡左	虫眼鏡左 🔍
虫眼鏡右	虫眼鏡右 🔎
懐中電灯	懐中電灯 🔦
ろうそく	ろうそく 🕯
ディヤランプ	ディヤランプ 🪔
荷札	荷札 🏷
巻きページ	巻きページ 📃
ページ	ページ 📄
ページに付箋	ページに付箋 📑
リングノート	リングノート 📒
ノート	ノート 📓
表紙付きノート	表紙付きノート 📔
閉じた本	閉じた本 📕
開いた本	開いた本 📖
緑の本	緑の本 📗
青の本	青の本 📘
オレンジの本	オレンジの本 📙
本の山	本の山 📚
巻き物	巻き物 📜
新聞	新聞 📰
しおり	しおり 🔖
丸めた新聞	丸めた新聞 🗞
ドル袋	ドル袋 💰
クレジットカード	クレジットカード 💳
円札	円札 💴
ドル札	ドル札 💵
ユーロ札	ユーロ札 💶
ポンド札	ポンド札 💷
羽が生えたお金	羽が生えたお金 💸
為替	為替 💹
レシート	レシート 🧾
コイン	コイン 🪙
封筒	封筒 ✉
送信トレイ	送信トレイ 📤
受信トレイ	受信トレイ 📥
荷物	荷物 📦
Eメール	Eメール 📧
メール受信中	メール受信中 📨
メール受信	メール受信 📩
閉じた郵便受け（手紙なし）	閉じた郵便受け（手紙なし） 📪
閉じた郵便受け（手紙あり）	閉じた郵便受け（手紙あり） 📫
開いた郵便受け（手紙あり）	開いた郵便受け（手紙あり） 📬
開いた郵便受け（手紙なし）	開いた郵便受け（手紙なし） 📭
郵便ポスト	郵便ポスト 📮
投票箱	投票箱 🗳
鉛筆	鉛筆 ✏
ペン先	ペン先 ✒
鉛筆とメモ	鉛筆とメモ 📝
ペン	ペン 🖊
万年筆	万年筆 🖋
絵筆	絵筆 🖌
クレヨン	クレヨン 🖍
はさみ	はさみ ✂
ブリーフケース	ブリーフケース 💼
フォルダー	フォルダー 📁
開いたフォルダー	開いたフォルダー 📂
カレンダー	カレンダー 📅
日めくりカレンダー	日めくりカレンダー 📆
カードインデックス	カードインデックス 📇
グラフ上向き	グラフ上向き 📈
グラフ下向き	グラフ下向き 📉
棒グラフ	棒グラフ 📊
クリップボード	クリップボード 📋
押しピン	押しピン 📌
丸い押しピン	丸い押しピン 📍
クリップ	クリップ 📎
定規	定規 📏
三角定規	三角定規 📐
つながったクリップ	つながったクリップ 🖇
カードフォルダー	カードフォルダー 🗂
カードファイルボックス	カードファイルボックス 🗃
ファイルキャビネット	ファイルキャビネット 🗄
ごみ箱	ごみ箱 🗑
メモ帳	メモ帳 🗒
月めくりカレンダー	月めくりカレンダー 🗓
閉じた錠とペン	閉じた錠とペン 🔏
閉じた錠と鍵	閉じた錠と鍵 🔐
鍵	鍵 🔑
閉じた錠	閉じた錠 🔒
開いた錠	開いた錠 🔓
古い鍵	古い鍵 🗝
ハンマーとつるはし	ハンマーとつるはし ⚒
クロスした剣	クロスした剣 ⚔
天秤	天秤 ⚖
歯車	歯車 ⚙
つるはし	つるはし ⛏
鎖	鎖 ⛓
弓矢	弓矢 🏹
リンクシンボル	リンクシンボル 🔗
レンチ	レンチ 🔧
ハンマー	ハンマー 🔨
ボルトとナット	ボルトとナット 🔩
水鉄砲	水鉄砲 🔫
万力	万力 🗜
短刀	短刀 🗡
ハンマーとレンチ	ハンマーとレンチ 🛠
盾	盾 🛡
白杖	白杖 🦯
工具箱	工具箱 🧰
U字型磁石	U字型磁石 🧲
ブーメラン	ブーメラン 🪃
斧	斧 🪓
のこぎり	のこぎり 🪚
ねじ回し	ねじ回し 🪛
はしご	はしご 🪜
フック	フック 🪝
蒸留器	蒸留器 ⚗
パラボラアンテナ	パラボラアンテナ 📡
顕微鏡	顕微鏡 🔬
望遠鏡	望遠鏡 🔭
試験管	試験管 🧪
ペトリ皿	ペトリ皿 🧫
DNA	DNA 🧬
注射器	注射器 💉
薬	薬 💊
血液	血液 🩸
絆創膏	絆創膏 🩹
聴診器	聴診器 🩺
ドア	ドア 🚪
便器	便器 🚽
シャワー	シャワー 🚿
バスタブ	バスタブ 🛁
ソファとランプ	ソファとランプ 🛋
ベッド	ベッド 🛏
ショッピングカート	ショッピングカート 🛒
エレベーター	エレベーター 🛗
消火器	消火器 🧯
ローション	ローション 🧴
安全ピン	安全ピン 🧷
ほうき	ほうき 🧹
かご	かご 🧺
トイレットペーパー	トイレットペーパー 🧻
石けん	石けん 🧼
スポンジ	スポンジ 🧽
椅子	椅子 🪑
剃刀	剃刀 🪒
鏡	鏡 🪞
窓	窓 🪟
ラバーカップ	ラバーカップ 🪠
バケツ	バケツ 🪣
ねずみ捕り	ねずみ捕り 🪤
歯ブラシ	歯ブラシ 🪥
棺桶	棺桶 ⚰
骨壺	骨壺 ⚱
モアイ	モアイ 🗿
煙草	煙草 🚬
墓石	墓石 🪦
プラカード	プラカード 🪧
車椅子	車椅子 ♿
ATM	ATM 🏧
ゴミ箱	ゴミ箱 🚮
飲料水	飲料水 🚰
男子トイレ	男子トイレ 🚹
女子トイレ	女子トイレ 🚺
トイレ	トイレ 🚻
ベビーシート	ベビーシート 🚼
WC	WC 🚾
出入国審査	出入国審査 🛂
税関	税関 🛃
手荷物受取	手荷物受取 🛄
手荷物預かり	手荷物預かり 🛅
放射能	放射能 ☢
バイオハザード	バイオハザード ☣
警告	警告 ⚠
車両進入禁止	車両進入禁止 ⛔
携帯電話禁止	携帯電話禁止 📵
18歳未満禁止	18歳未満禁止 🔞
車両通行止め	車両通行止め 🚫
禁煙	禁煙 🚭
ポイ捨て禁止	ポイ捨て禁止 🚯
飲用不可	飲用不可 🚱
自転車禁止	自転車禁止 🚳
歩行者立入禁止	歩行者立入禁止 🚷
児童横断	児童横断 🚸
左右矢印	左右矢印 ↔
上下矢印	上下矢印 ↕
左上矢印	左上矢印 ↖
右上矢印	右上矢印 ↗
右下矢印	右下矢印 ↘
左下矢印	左下矢印 ↙
右カーブ矢印	右カーブ矢印 ↩
左カーブ矢印	左カーブ矢印 ↪
右矢印	右矢印 ➡
上カーブ矢印	上カーブ矢印 ⤴
下カーブ矢印	下カーブ矢印 ⤵
左矢印	左矢印 ⬅
上矢印	上矢印 ⬆
下矢印	下矢印 ⬇
右回り縦矢印	右回り縦矢印 🔃
左回り矢印	左回り矢印 🔄
BACK矢印	BACK矢印 🔙
END矢印	END矢印 🔚
ON矢印	ON矢印 🔛
SOON矢印	SOON矢印 🔜
TOP矢印	TOP矢印 🔝
八端十字架	八端十字架 ☦
星と三日月	星と三日月 ☪
ピースマーク	ピースマーク ☮
陰陽	陰陽 ☯
法輪	法輪 ☸
原子のシンボル	原子のシンボル ⚛
十字架	十字架 ✝
ダビデの星	ダビデの星 ✡
六芒星	六芒星 🔯
オーム	オーム 🕉
メノーラー	メノーラー 🕎
礼拝所	礼拝所 🛐
おひつじ座	おひつじ座 ♈
おうし座	おうし座 ♉
ふたご座	ふたご座 ♊
かに座	かに座 ♋
しし座	しし座 ♌
おとめ座	おとめ座 ♍
てんびん座	てんびん座 ♎
さそり座	さそり座 ♏
いて座	いて座 ♐
やぎ座	やぎ座 ♑
みずがめ座	みずがめ座 ♒
うお座	うお座 ♓
へびつかい座	へびつかい座 ⛎
取り出しボタン	取り出しボタン ⏏
早送りボタン	早送りボタン ⏩
早戻しボタン	早戻しボタン ⏪
高速上ボタン	高速上ボタン ⏫
高速下ボタン	高速下ボタン ⏬
次の曲ボタン	次の曲ボタン ⏭
前の曲ボタン	前の曲ボタン ⏮
再生／一時停止ボタン	再生／一時停止ボタン ⏯
一時停止ボタン	一時停止ボタン ⏸
停止ボタン	停止ボタン ⏹
録音録画ボタン	録音録画ボタン ⏺
再生ボタン	再生ボタン ▶
逆再生ボタン	逆再生ボタン ◀
映画	映画 🎦
マナーモード	マナーモード 📳
携帯電話電源オフ	携帯電話電源オフ 📴
アンテナマーク	アンテナマーク 📶
シャッフルボタン	シャッフルボタン 🔀
リピートボタン	リピートボタン 🔁
1曲リピートボタン	1曲リピートボタン 🔂
低輝度	低輝度 🔅
高輝度	高輝度 🔆
上ボタン	上ボタン 🔼
下ボタン	下ボタン 🔽
女性のマーク	女性のマーク ♀
男性のマーク	男性のマーク ♂
トランスジェンダーのマーク	トランスジェンダーのマーク ⚧
著作権マーク	著作権マーク ©
登録商標マーク	登録商標マーク ®
二重感嘆符	二重感嘆符 ‼
感嘆符疑問符	感嘆符疑問符 ⁉
商標マーク	商標マーク ™
チェックボックス	チェックボックス ☑
リサイクルマーク	リサイクルマーク ♻
無限大	無限大 ♾
医療のシンボル	医療のシンボル ⚕
フルール・ド・リス	フルール・ド・リス ⚜
白抜きのチェック	白抜きのチェック ✅
太字のチェック	太字のチェック ✔
掛け算	掛け算 ✖
八角アスタリスク	八角アスタリスク ✳
八角星	八角星 ✴
スパークル	スパークル ❇
バツ	バツ ❌
白抜きのバツ	白抜きのバツ ❎
赤い疑問符	赤い疑問符 ❓
白い疑問符	白い疑問符 ❔
白い感嘆符	白い感嘆符 ❕
赤い感嘆符	赤い感嘆符 ❗
プラス	プラス ➕
マイナス	マイナス ➖
割り算	割り算 ➗
ループ	ループ ➰
ダブルループ	ダブルループ ➿
太い丸	太い丸 ⭕
波線	波線 〰
いおりてん	いおりてん 〽
外貨両替	外貨両替 💱
ドル記号	ドル記号 💲
名札	名札 📛
初心者マーク	初心者マーク 🔰
囲み数字: #	囲み数字: # #️⃣
囲み数字: *	囲み数字: * *️⃣
囲み数字: 0	囲み数字: 0 0️⃣
囲み数字: 1	囲み数字: 1 1️⃣
囲み数字: 2	囲み数字: 2 2️⃣
囲み数字: 3	囲み数字: 3 3️⃣
囲み数字: 4	囲み数字: 4 4️⃣
囲み数字: 5	囲み数字: 5 5️⃣
囲み数字: 6	囲み数字: 6 6️⃣
囲み数字: 7	囲み数字: 7 7️⃣
囲み数字: 8	囲み数字: 8 8️⃣
囲み数字: 9	囲み数字: 9 9️⃣
囲み数字: 10	囲み数字: 10 🔟
iマーク	iマーク ℹ
丸いMマーク	丸いMマーク Ⓜ
祝マーク	祝マーク ㊗
マル秘	マル秘 ㊙
血液型A型	血液型A型 🅰
血液型B型	血液型B型 🅱
血液型O型	血液型O型 🅾
Pマーク	Pマーク 🅿
血液型AB型	血液型AB型 🆎
CLマーク	CLマーク 🆑
COOLマーク	COOLマーク 🆒
FREEマーク	FREEマーク 🆓
IDマーク	IDマーク 🆔
NEWマーク	NEWマーク 🆕
NGマーク	NGマーク 🆖
OKマーク	OKマーク 🆗
SOSマーク	SOSマーク 🆘
UPマーク	UPマーク 🆙
VSマーク	VSマーク 🆚
ココのマーク	ココのマーク 🈁
サのマーク	サのマーク 🈂
無マーク	無マーク 🈚
指マーク	指マーク 🈯
禁マーク	禁マーク 🈲
空マーク	空マーク 🈳
合マーク	合マーク 🈴
満マーク	満マーク 🈵
有マーク	有マーク 🈶
月マーク	月マーク 🈷
申マーク	申マーク 🈸
割マーク	割マーク 🈹
営マーク	営マーク 🈺
マル得	マル得 🉐
可マーク	可マーク 🉑
英大文字の入力	英大文字の入力 🔠
英小文字の入力	英小文字の入力 🔡
数字の入力	数字の入力 🔢
記号の入力	記号の入力 🔣
英字の入力	英字の入力 🔤
黒四角小	黒四角小 ▪
白四角小	白四角小 ▫
白四角大	白四角大 ◻
黒四角大	黒四角大 ◼
白四角中	白四角中 ◽
黒四角中	黒四角中 ◾
白い丸	白い丸 ⚪
黒い丸	黒い丸 ⚫
黒四角特大	黒四角特大 ⬛
白四角特大	白四角特大 ⬜
ドット付きひし形	ドット付きひし形 💠
ラジオボタン	ラジオボタン 🔘
黒枠四角	黒枠四角 🔲
白枠四角	白枠四角 🔳
赤い丸	赤い丸 🔴
青い丸	青い丸 🔵
大きいオレンジのひし形	大きいオレンジのひし形 🔶
大きい青のひし形	大きい青のひし形 🔷
小さいオレンジのひし形	小さいオレンジのひし形 🔸
小さい青のひし形	小さい青のひし形 🔹
赤い上三角	赤い上三角 🔺
赤い下三角	赤い下三角 🔻
オレンジの丸	オレンジの丸 🟠
黄色い丸	黄色い丸 🟡
緑の丸	緑の丸 🟢
紫の丸	紫の丸 🟣
茶色の丸	茶色の丸 🟤
赤い四角	赤い四角 🟥
青い四角	青い四角 🟦
オレンジの四角	オレンジの四角 🟧
黄色い四角	黄色い四角 🟨
緑の四角	緑の四角 🟩
紫の四角	紫の四角 🟪
茶色い四角	茶色い四角 🟫
祝日の旗	祝日の旗 🎌
チェッカーフラッグ	チェッカーフラッグ 🏁
白旗	白旗 🏳
トランスジェンダーフラッグ	トランスジェンダーフラッグ 🏳️‍⚧️
レインボーフラッグ	レインボーフラッグ 🏳️‍🌈
黒旗	黒旗 🏴
海賊旗	海賊旗 🏴‍☠️
三角の旗	三角の旗 🚩
アセンション島	アセンション島 🇦🇨
アンドラ	アンドラ 🇦🇩
アラブ首長国連邦	アラブ首長国連邦 🇦🇪
アフガニスタン	アフガニスタン 🇦🇫
アンティグア・バーブーダ	アンティグア・バーブーダ 🇦🇬
アンギラ	アンギラ 🇦🇮
アルバニア	アルバニア 🇦🇱
アルメニア	アルメニア 🇦🇲
アンゴラ	アンゴラ 🇦🇴
南極	南極 🇦🇶
アルゼンチン	アルゼンチン 🇦🇷
米領サモア	米領サモア 🇦🇸
オーストリア	オーストリア 🇦🇹
オーストラリア	オーストラリア 🇦🇺
アルバ	アルバ 🇦🇼
オーランド諸島	オーランド諸島 🇦🇽
アゼルバイジャン	アゼルバイジャン 🇦🇿
ボスニア・ヘルツェゴビナ	ボスニア・ヘルツェゴビナ 🇧🇦
バルバドス	バルバドス 🇧🇧
バングラデシュ	バングラデシュ 🇧🇩
ベルギー	ベルギー 🇧🇪
ブルキナファソ	ブルキナファソ 🇧🇫
ブルガリア	ブルガリア 🇧🇬
バーレーン	バーレーン 🇧🇭
ブルンジ	ブルンジ 🇧🇮
ベナン	ベナン 🇧🇯
サン・バルテルミー	サン・バルテルミー 🇧🇱
バミューダ	バミューダ 🇧🇲
ブルネイ	ブルネイ 🇧🇳
ボリビア	ボリビア 🇧🇴
オランダ領カリブ	オランダ領カリブ 🇧🇶
ブラジル	ブラジル 🇧🇷
バハマ	バハマ 🇧🇸
ブータン	ブータン 🇧🇹
ブーベ島	ブーベ島 🇧🇻
ボツワナ	ボツワナ 🇧🇼
ベラルーシ	ベラルーシ 🇧🇾
ベリーズ	ベリーズ 🇧🇿
カナダ	カナダ 🇨🇦
ココス(キーリング)諸島	ココス(キーリング)諸島 🇨🇨
コンゴ民主共和国(キンシャサ)	コンゴ民主共和国(キンシャサ) 🇨🇩
中央アフリカ共和国	中央アフリカ共和国 🇨🇫
コンゴ共和国(ブラザビル)	コンゴ共和国(ブラザビル) 🇨🇬
スイス	スイス 🇨🇭
コートジボワール	コートジボワール 🇨🇮
クック諸島	クック諸島 🇨🇰
チリ	チリ 🇨🇱
カメルーン	カメルーン 🇨🇲
中国	中国 🇨🇳
コロンビア	コロンビア 🇨🇴
クリッパートン島	クリッパートン島 🇨🇵
コスタリカ	コスタリカ 🇨🇷
キューバ	キューバ 🇨🇺
カーボベルデ	カーボベルデ 🇨🇻
キュラソー	キュラソー 🇨🇼
クリスマス島	クリスマス島 🇨🇽
キプロス	キプロス 🇨🇾
チェコ	チェコ 🇨🇿
ドイツ	ドイツ 🇩🇪
ディエゴガルシア島	ディエゴガルシア島 🇩🇬
ジブチ	ジブチ 🇩🇯
デンマーク	デンマーク 🇩🇰
ドミニカ国	ドミニカ国 🇩🇲
ドミニカ共和国	ドミニカ共和国 🇩🇴
アルジェリア	アルジェリア 🇩🇿
セウタ・メリリャ	セウタ・メリリャ 🇪🇦
エクアドル	エクアドル 🇪🇨
エストニア	エストニア 🇪🇪
エジプト	エジプト 🇪🇬
西サハラ	西サハラ 🇪🇭
エリトリア	エリトリア 🇪🇷
スペイン	スペイン 🇪🇸
エチオピア	エチオピア 🇪🇹
欧州連合	欧州連合 🇪🇺
フィンランド	フィンランド 🇫🇮
フィジー	フィジー 🇫🇯
フォークランド諸島	フォークランド諸島 🇫🇰
ミクロネシア連邦	ミクロネシア連邦 🇫🇲
フェロー諸島	フェロー諸島 🇫🇴
フランス	フランス 🇫🇷
ガボン	ガボン 🇬🇦
イギリス	イギリス 🇬🇧
グレナダ	グレナダ 🇬🇩
ジョージア	ジョージア 🇬🇪
仏領ギアナ	仏領ギアナ 🇬🇫
ガーンジー	ガーンジー 🇬🇬
ガーナ	ガーナ 🇬🇭
ジブラルタル	ジブラルタル 🇬🇮
グリーンランド	グリーンランド 🇬🇱
ガンビア	ガンビア 🇬🇲
ギニア	ギニア 🇬🇳
グアドループ	グアドループ 🇬🇵
赤道ギニア	赤道ギニア 🇬🇶
ギリシャ	ギリシャ 🇬🇷
サウスジョージア・サウスサンドウィッチ諸島	サウスジョージア・サウスサンドウィッチ諸島 🇬🇸
グアテマラ	グアテマラ 🇬🇹
グアム	グアム 🇬🇺
ギニアビサウ	ギニアビサウ 🇬🇼
ガイアナ	ガイアナ 🇬🇾
中華人民共和国香港特別行政区	中華人民共和国香港特別行政区 🇭🇰
ハード島・マクドナルド諸島	ハード島・マクドナルド諸島 🇭🇲
ホンジュラス	ホンジュラス 🇭🇳
クロアチア	クロアチア 🇭🇷
ハイチ	ハイチ 🇭🇹
ハンガリー	ハンガリー 🇭🇺
カナリア諸島	カナリア諸島 🇮🇨
インドネシア	インドネシア 🇮🇩
アイルランド	アイルランド 🇮🇪
イスラエル	イスラエル 🇮🇱
マン島	マン島 🇮🇲
インド	インド 🇮🇳
英領インド洋地域	英領インド洋地域 🇮🇴
イラク	イラク 🇮🇶
イラン	イラン 🇮🇷
アイスランド	アイスランド 🇮🇸
イタリア	イタリア 🇮🇹
ジャージー	ジャージー 🇯🇪
ジャマイカ	ジャマイカ 🇯🇲
ヨルダン	ヨルダン 🇯🇴
日本	日本 🇯🇵
ケニア	ケニア 🇰🇪
キルギス	キルギス 🇰🇬
カンボジア	カンボジア 🇰🇭
キリバス	キリバス 🇰🇮
コモロ	コモロ 🇰🇲
セントクリストファー・ネーヴィス	セントクリストファー・ネーヴィス 🇰🇳
北朝鮮	北朝鮮 🇰🇵
韓国	韓国 🇰🇷
クウェート	クウェート 🇰🇼
ケイマン諸島	ケイマン諸島 🇰🇾
カザフスタン	カザフスタン 🇰🇿
ラオス	ラオス 🇱🇦
レバノン	レバノン 🇱🇧
セントルシア	セントルシア 🇱🇨
リヒテンシュタイン	リヒテンシュタイン 🇱🇮
スリランカ	スリランカ 🇱🇰
リベリア	リベリア 🇱🇷
レソト	レソト 🇱🇸
リトアニア	リトアニア 🇱🇹
ルクセンブルク	ルクセンブルク 🇱🇺
ラトビア	ラトビア 🇱🇻
リビア	リビア 🇱🇾
モロッコ	モロッコ 🇲🇦
モナコ	モナコ 🇲🇨
モルドバ	モルドバ 🇲🇩
モンテネグロ	モンテネグロ 🇲🇪
サン・マルタン	サン・マルタン 🇲🇫
マダガスカル	マダガスカル 🇲🇬
マーシャル諸島	マーシャル諸島 🇲🇭
北マケドニア	北マケドニア 🇲🇰
マリ	マリ 🇲🇱
ミャンマー (ビルマ)	ミャンマー (ビルマ) 🇲🇲
モンゴル	モンゴル 🇲🇳
中華人民共和国マカオ特別行政区	中華人民共和国マカオ特別行政区 🇲🇴
北マリアナ諸島	北マリアナ諸島 🇲🇵
マルティニーク	マルティニーク 🇲🇶
モーリタニア	モーリタニア 🇲🇷
モントセラト	モントセラト 🇲🇸
マルタ	マルタ 🇲🇹
モーリシャス	モーリシャス 🇲🇺
モルディブ	モルディブ 🇲🇻
マラウイ	マラウイ 🇲🇼
メキシコ	メキシコ 🇲🇽
マレーシア	マレーシア 🇲🇾
モザンビーク	モザンビーク 🇲🇿
ナミビア	ナミビア 🇳🇦
ニューカレドニア	ニューカレドニア 🇳🇨
ニジェール	ニジェール 🇳🇪
ノーフォーク島	ノーフォーク島 🇳🇫
ナイジェリア	ナイジェリア 🇳🇬
ニカラグア	ニカラグア 🇳🇮
オランダ	オランダ 🇳🇱
ノルウェー	ノルウェー 🇳🇴
ネパール	ネパール 🇳🇵
ナウル	ナウル 🇳🇷
ニウエ	ニウエ 🇳🇺
ニュージーランド	ニュージーランド 🇳🇿
オマーン	オマーン 🇴🇲
パナマ	パナマ 🇵🇦
ペルー	ペルー 🇵🇪
仏領ポリネシア	仏領ポリネシア 🇵🇫
パプアニューギニア	パプアニューギニア 🇵🇬
フィリピン	フィリピン 🇵🇭
パキスタン	パキスタン 🇵🇰
ポーランド	ポーランド 🇵🇱
サンピエール島・ミクロン島	サンピエール島・ミクロン島 🇵🇲
ピトケアン諸島	ピトケアン諸島 🇵🇳
プエルトリコ	プエルトリコ 🇵🇷
パレスチナ自治区	パレスチナ自治区 🇵🇸
ポルトガル	ポルトガル 🇵🇹
パラオ	パラオ 🇵🇼
パラグアイ	パラグアイ 🇵🇾
カタール	カタール 🇶🇦
レユニオン	レユニオン 🇷🇪
ルーマニア	ルーマニア 🇷🇴
セルビア	セルビア 🇷🇸
ロシア	ロシア 🇷🇺
ルワンダ	ルワンダ 🇷🇼
サウジアラビア	サウジアラビア 🇸🇦
ソロモン諸島	ソロモン諸島 🇸🇧
セーシェル	セーシェル 🇸🇨
スーダン	スーダン 🇸🇩
スウェーデン	スウェーデン 🇸🇪
シンガポール	シンガポール 🇸🇬
セントヘレナ	セントヘレナ 🇸🇭
スロベニア	スロベニア 🇸🇮
スバールバル諸島・ヤンマイエン島	スバールバル諸島・ヤンマイエン島 🇸🇯
スロバキア	スロバキア 🇸🇰
シエラレオネ	シエラレオネ 🇸🇱
サンマリノ	サンマリノ 🇸🇲
セネガル	セネガル 🇸🇳
ソマリア	ソマリア 🇸🇴
スリナム	スリナム 🇸🇷
南スーダン	南スーダン 🇸🇸
サントメ・プリンシペ	サントメ・プリンシペ 🇸🇹
エルサルバドル	エルサルバドル 🇸🇻
シント・マールテン	シント・マールテン 🇸🇽
シリア	シリア 🇸🇾
エスワティニ	エスワティニ 🇸🇿
トリスタン・ダ・クーニャ	トリスタン・ダ・クーニャ 🇹🇦
タークス・カイコス諸島	タークス・カイコス諸島 🇹🇨
チャド	チャド 🇹🇩
仏領極南諸島	仏領極南諸島 🇹🇫
トーゴ	トーゴ 🇹🇬
タイ	タイ 🇹🇭
タジキスタン	タジキスタン 🇹🇯
トケラウ	トケラウ 🇹🇰
東ティモール	東ティモール 🇹🇱
トルクメニスタン	トルクメニスタン 🇹🇲
チュニジア	チュニジア 🇹🇳
トンガ	トンガ 🇹🇴
トルコ	トルコ 🇹🇷
トリニダード・トバゴ	トリニダード・トバゴ 🇹🇹
ツバル	ツバル 🇹🇻
台湾	台湾 🇹🇼
タンザニア	タンザニア 🇹🇿
ウクライナ	ウクライナ 🇺🇦
ウガンダ	ウガンダ 🇺🇬
合衆国領有小離島	合衆国領有小離島 🇺🇲
国際連合	国際連合 🇺🇳
アメリカ合衆国	アメリカ合衆国 🇺🇸
ウルグアイ	ウルグアイ 🇺🇾
ウズベキスタン	ウズベキスタン 🇺🇿
バチカン市国	バチカン市国 🇻🇦
セントビンセント及びグレナディーン諸島	セントビンセント及びグレナディーン諸島 🇻🇨
ベネズエラ	ベネズエラ 🇻🇪
英領ヴァージン諸島	英領ヴァージン諸島 🇻🇬
米領ヴァージン諸島	米領ヴァージン諸島 🇻🇮
ベトナム	ベトナム 🇻🇳
バヌアツ	バヌアツ 🇻🇺
ウォリス・フツナ	ウォリス・フツナ 🇼🇫
サモア	サモア 🇼🇸
コソボ	コソボ 🇽🇰
イエメン	イエメン 🇾🇪
マヨット	マヨット 🇾🇹
南アフリカ	南アフリカ 🇿🇦
ザンビア	ザンビア 🇿🇲
ジンバブエ	ジンバブエ 🇿🇼
イングランド	イングランド 🏴󠁧󠁢󠁥󠁮󠁧󠁿
スコットランド	スコットランド 🏴󠁧󠁢󠁳󠁣󠁴󠁿
ウェールズ	ウェールズ 🏴󠁧󠁢󠁷󠁬󠁳󠁿
